state_fips,state,soc_minor,civ_noninst_pop_employed,civ_noninst_pop_employed_local,civ_noninst_pop_employed_immigrant,civ_noninst_pop_employed_central_america,civ_noninst_pop_employed_south_america,civ_noninst_pop_employed_mexico,count,count_local,count_immigrant,count_central_america,count_south_america,count_mexico,minor_group,title
01,Alabama,111,21726,21056,670,11,70,0,1175,1137,38,2,5,1,11-1000,Top Executives
01,Alabama,112,9659,9384,275,0,21,15,489,474,15,0,3,1,11-2000,"Advertising, Marketing, Promotions, Public Relations, and Sales Managers"
01,Alabama,113,37708,36041,1667,97,54,60,2031,1947,84,4,4,4,11-3000,Operations Specialties Managers
01,Alabama,119,101662,97026,4636,434,119,1425,5512,5308,204,16,6,48,11-9000,Other Management Occupations
01,Alabama,131,49822,47730,2092,179,129,323,2636,2548,88,8,8,11,13-1000,Business Operations Specialists
01,Alabama,132,34414,33131,1283,17,27,119,1927,1862,65,1,4,5,13-2000,Financial Specialists
01,Alabama,1512,45535,43023,2512,75,113,312,2263,2158,105,3,4,9,15-1200,Computer Occupations
01,Alabama,152,1682,1623,59,0,0,0,108,103,5,0,0,0,15-2000,Mathematical Science Occupations
01,Alabama,171,2020,1888,132,0,35,0,110,105,5,0,1,0,17-1000,"Architects, Surveyors, and Cartographers"
01,Alabama,172,29387,27066,2321,96,170,161,1549,1443,106,4,5,10,17-2000,Engineers
01,Alabama,173,9508,9324,184,0,0,25,531,516,15,0,0,5,17-3000,"Drafters, Engineering Technicians, and Mapping Technicians"
01,Alabama,191,2395,1965,430,0,28,99,117,100,17,0,1,2,19-1000,Life Scientists
01,Alabama,192,3725,3060,665,0,0,27,185,153,32,0,0,1,19-2000,Physical Scientists
01,Alabama,193,1295,1258,37,0,37,0,83,81,2,0,1,0,19-3000,Social Scientists and Related Workers
01,Alabama,194,5309,5072,237,0,0,120,275,262,13,0,1,1,19-4000,"Life, Physical, and Social Science Technicians"
01,Alabama,195,1049,943,106,45,42,0,61,58,3,1,1,0,19-5000,Occupational Health and Safety Specialists and Technicians
01,Alabama,211,22908,22343,565,62,19,0,1234,1209,25,2,2,2,21-1000,"Counselors, Social Workers, and Other Community and Social Service Specialists"
01,Alabama,212,10986,10537,449,32,22,196,650,622,28,1,4,7,21-2000,Religious Workers
01,Alabama,231,9983,9902,81,0,0,52,579,575,4,0,0,1,23-1000,"Lawyers, Judges, and Related Workers"
01,Alabama,232,5795,5753,42,0,0,4,320,315,5,0,1,2,23-2000,Legal Support Workers
01,Alabama,251,17931,13990,3941,0,200,68,1008,843,165,0,8,4,25-1000,Postsecondary Teachers
01,Alabama,252,75258,74175,1083,46,76,295,4591,4521,70,4,5,8,25-2000,"Preschool, Elementary, Middle, Secondary, and Special Education Teachers"
01,Alabama,253,11007,10725,282,0,22,22,721,697,24,3,2,2,25-3000,Other Teachers and Instructors
01,Alabama,254,2975,2953,22,0,0,0,185,184,1,0,0,0,25-4000,"Librarians, Curators, and Archivists"
01,Alabama,259,12575,12045,530,4,75,39,836,803,33,1,5,2,25-9000,Other Educational Instruction and Library Occupations
01,Alabama,271,8321,8058,263,0,76,0,511,501,10,0,3,0,27-1000,Art and Design Workers
01,Alabama,272,7316,7092,224,0,26,14,489,476,13,0,2,2,27-2000,"Entertainers and Performers, Sports and Related Workers"
01,Alabama,273,7153,6763,390,0,99,66,408,394,14,2,2,3,27-3000,Media and Communication Workers
01,Alabama,274,2793,2726,67,0,0,0,169,167,2,0,0,0,27-4000,Media and Communication Equipment Workers
01,Alabama,291,92084,88292,3792,49,175,137,5004,4809,195,5,9,4,29-1000,Healthcare Diagnosing or Treating Practitioners
01,Alabama,292,44233,42904,1329,0,92,174,2466,2403,63,1,5,8,29-2000,Health Technologists and Technicians
01,Alabama,299,1043,1028,15,0,0,0,56,54,2,0,0,0,29-9000,Other Healthcare Practitioners and Technical Occupations
01,Alabama,3111,35531,34794,737,12,0,117,1892,1855,37,1,0,6,31-1100,"Home Health and Personal Care Aides; and Nursing Assistants, Orderlies, and Psychiatric Aides"
01,Alabama,312,2790,2767,23,2,0,0,166,164,2,1,0,0,31-2000,Occupational Therapy and Physical Therapist Assistants and Aides
01,Alabama,319,16364,15992,372,0,8,11,865,848,17,1,1,1,31-9000,Other Healthcare Support Occupations
01,Alabama,331,4570,4514,56,0,0,0,274,270,4,1,0,0,33-1000,Supervisors of Protective Service Workers
01,Alabama,332,5945,5837,108,10,0,73,298,294,4,1,0,2,33-2000,Firefighting and Prevention Workers
01,Alabama,333,16229,16178,51,7,0,14,885,881,4,1,0,1,33-3000,Law Enforcement Workers
01,Alabama,339,15393,15210,183,32,0,21,940,925,15,1,0,1,33-9000,Other Protective Service Workers
01,Alabama,351,12741,11637,1104,48,46,284,640,602,38,1,3,8,35-1000,Supervisors of Food Preparation and Serving Workers
01,Alabama,352,44574,40845,3729,355,194,2038,2690,2550,140,17,7,62,35-2000,Cooks and Food Preparation Workers
01,Alabama,353,41338,38732,2606,281,82,1073,2360,2257,103,9,3,40,35-3000,Food and Beverage Serving Workers
01,Alabama,359,11249,10451,798,156,0,414,754,718,36,6,1,15,35-9000,Other Food Preparation and Serving Related Workers
01,Alabama,371,5842,5650,192,31,60,74,286,272,14,3,3,6,37-1000,Supervisors of Building and Grounds Cleaning and Maintenance Workers
01,Alabama,372,51202,46769,4433,707,448,2552,3121,2941,180,31,12,93,37-2000,Building Cleaning and Pest Control Workers
01,Alabama,373,18376,16458,1918,582,11,1163,1088,1023,65,13,1,43,37-3000,Grounds Maintenance Workers
01,Alabama,391,1164,1060,104,0,0,57,56,51,5,0,0,1,39-1000,Supervisors of Personal Care and Service Workers
01,Alabama,392,3379,3281,98,0,17,1,213,206,7,0,1,2,39-2000,Animal Care and Service Workers
01,Alabama,393,2861,2819,42,0,0,0,186,181,5,0,0,0,39-3000,Entertainment Attendants and Related Workers
01,Alabama,394,615,615,0,0,0,0,44,44,0,0,0,0,39-4000,Funeral Service Workers
01,Alabama,395,16340,13835,2505,5,8,266,836,725,111,1,2,10,39-5000,Personal Appearance Workers
01,Alabama,396,302,302,0,0,0,0,11,11,0,0,0,0,39-6000,"Baggage Porters, Bellhops, and Concierges"
01,Alabama,397,427,411,16,0,0,0,35,34,1,0,0,0,39-7000,Tour and Travel Guides
01,Alabama,399,20851,20090,761,161,45,25,1605,1555,50,4,4,4,39-9000,Other Personal Care and Service Workers
01,Alabama,411,59764,57313,2451,139,58,277,3252,3150,102,3,4,10,41-1000,Supervisors of Sales Workers
01,Alabama,412,94326,91143,3183,368,66,339,6037,5860,177,10,4,26,41-2000,Retail Sales Workers
01,Alabama,413,16736,16359,377,18,0,0,884,870,14,1,1,0,41-3000,"Sales Representatives, Services"
01,Alabama,414,17359,17085,274,4,0,0,914,901,13,1,1,0,41-4000,"Sales Representatives, Wholesale and Manufacturing"
01,Alabama,419,13051,12814,237,0,16,17,747,730,17,0,1,4,41-9000,Other Sales and Related Workers
01,Alabama,431,17200,16899,301,0,52,17,985,968,17,0,1,1,43-1000,Supervisors of Office and Administrative Support Workers
01,Alabama,432,1376,1353,23,0,0,0,86,84,2,0,0,1,43-2000,Communications Equipment Operators
01,Alabama,433,32834,32147,687,88,43,131,1936,1903,33,5,2,5,43-3000,Financial Clerks
01,Alabama,434,64739,63397,1342,61,134,290,3699,3624,75,3,6,13,43-4000,Information and Record Clerks
01,Alabama,435,27394,27079,315,59,0,150,1611,1600,11,1,0,5,43-5000,"Material Recording, Scheduling, Dispatching, and Distributing Workers"
01,Alabama,436,37690,36891,799,50,35,221,2653,2599,54,3,5,11,43-6000,Secretaries and Administrative Assistants
01,Alabama,439,34340,33614,726,18,0,184,2092,2055,37,2,0,4,43-9000,Other Office and Administrative Support Workers
01,Alabama,451,924,792,132,21,0,93,61,54,7,1,0,5,45-1000,"Supervisors of Farming, Fishing, and Forestry Workers"
01,Alabama,452,5622,5011,611,104,0,438,442,411,31,5,1,16,45-2000,Agricultural Workers
01,Alabama,453,600,561,39,0,0,0,27,24,3,0,0,0,45-3000,Fishing and Hunting Workers
01,Alabama,454,1471,1454,17,11,0,6,91,89,2,1,0,1,45-4000,"Forest, Conservation, and Logging Workers"
01,Alabama,471,9959,9514,445,26,2,333,566,550,16,1,1,10,47-1000,Supervisors of Construction and Extraction Workers
01,Alabama,472,87268,74583,12685,2537,237,9275,4622,4243,379,78,9,264,47-2000,Construction Trades Workers
01,Alabama,473,738,697,41,0,0,41,41,40,1,0,0,1,47-3000,"Helpers, Construction Trades"
01,Alabama,474,4246,4212,34,31,0,3,241,237,4,3,0,1,47-4000,Other Construction and Related Workers
01,Alabama,475,3073,2892,181,0,0,0,179,178,1,0,0,0,47-5000,Extraction Workers
01,Alabama,491,5153,5125,28,14,0,0,299,297,2,1,0,0,49-1000,"Supervisors of Installation, Maintenance, and Repair Workers"
01,Alabama,492,6780,6459,321,6,6,138,407,395,12,1,1,3,49-2000,"Electrical and Electronic Equipment Mechanics, Installers, and Repairers"
01,Alabama,493,27895,26537,1358,251,173,402,1585,1533,52,6,1,17,49-3000,"Vehicle and Mobile Equipment Mechanics, Installers, and Repairers"
01,Alabama,499,36858,36073,785,106,26,275,2087,2049,38,3,2,10,49-9000,"Other Installation, Maintenance, and Repair Occupations"
01,Alabama,511,20388,19175,1213,338,68,550,1099,1059,40,7,1,20,51-1000,Supervisors of Production Workers
01,Alabama,512,30347,28960,1387,545,28,538,1529,1478,51,7,6,24,51-2000,Assemblers and Fabricators
01,Alabama,513,11539,9206,2333,764,0,847,631,542,89,23,0,32,51-3000,Food Processing Workers
01,Alabama,514,36976,35065,1911,522,18,683,1941,1864,77,13,1,40,51-4000,Metal Workers and Plastic Workers
01,Alabama,5151,2863,2769,94,0,0,0,143,139,4,0,0,0,51-5100,Printing Workers
01,Alabama,516,9168,7687,1481,413,0,803,553,495,58,14,0,27,51-6000,"Textile, Apparel, and Furnishings Workers"
01,Alabama,517,3594,3455,139,20,0,74,193,188,5,1,0,3,51-7000,Woodworkers
01,Alabama,518,4797,4706,91,0,0,0,302,300,2,0,0,0,51-8000,Plant and System Operators
01,Alabama,519,58650,55124,3526,674,12,1865,3258,3119,139,23,1,63,51-9000,Other Production Occupations
01,Alabama,531,3088,2888,200,2,0,0,189,179,10,1,1,0,53-1000,Supervisors of Transportation and Material Moving Workers
01,Alabama,532,3523,3426,97,0,24,0,188,181,7,0,2,0,53-2000,Air Transportation Workers
01,Alabama,533,65393,64128,1265,23,0,384,3648,3599,49,1,1,13,53-3000,Motor Vehicle Operators
01,Alabama,534,2371,2371,0,0,0,0,125,125,0,0,0,0,53-4000,Rail Transportation Workers
01,Alabama,535,1897,1854,43,0,0,0,90,88,2,0,0,0,53-5000,Water Transportation Workers
01,Alabama,536,2694,2606,88,0,0,0,178,173,5,0,0,1,53-6000,Other Transportation Workers
01,Alabama,537,89389,85309,4080,677,23,1637,5046,4877,169,23,3,68,53-7000,Material Moving Workers
02,Alaska,111,5052,4457,595,0,301,0,219,213,6,0,1,0,11-1000,Top Executives
02,Alaska,112,657,657,0,0,0,0,29,29,0,0,0,0,11-2000,"Advertising, Marketing, Promotions, Public Relations, and Sales Managers"
02,Alaska,113,5928,5287,641,0,0,92,234,214,20,0,0,3,11-3000,Operations Specialties Managers
02,Alaska,119,20667,19150,1517,0,0,309,1095,1039,56,0,1,9,11-9000,Other Management Occupations
02,Alaska,131,7758,7057,701,0,0,2,310,293,17,0,0,1,13-1000,Business Operations Specialists
02,Alaska,132,5368,4695,673,58,82,0,203,186,17,2,1,0,13-2000,Financial Specialists
02,Alaska,1512,5420,4883,537,0,0,89,201,187,14,0,1,2,15-1200,Computer Occupations
02,Alaska,152,595,482,113,0,0,0,17,13,4,0,0,0,15-2000,Mathematical Science Occupations
02,Alaska,171,841,814,27,27,0,0,36,34,2,1,0,0,17-1000,"Architects, Surveyors, and Cartographers"
02,Alaska,172,4101,3909,192,0,0,0,168,159,9,0,1,0,17-2000,Engineers
02,Alaska,173,2152,2099,53,0,0,0,100,89,11,1,0,0,17-3000,"Drafters, Engineering Technicians, and Mapping Technicians"
02,Alaska,191,1326,1248,78,0,0,0,67,64,3,0,0,0,19-1000,Life Scientists
02,Alaska,192,1511,1499,12,0,0,0,54,51,3,0,0,0,19-2000,Physical Scientists
02,Alaska,193,900,870,30,0,0,0,40,39,1,0,0,0,19-3000,Social Scientists and Related Workers
02,Alaska,194,1624,1569,55,0,0,48,89,86,3,0,0,1,19-4000,"Life, Physical, and Social Science Technicians"
02,Alaska,195,733,689,44,0,0,0,20,18,2,0,0,0,19-5000,Occupational Health and Safety Specialists and Technicians
02,Alaska,211,6933,6545,388,67,61,0,348,336,12,1,2,0,21-1000,"Counselors, Social Workers, and Other Community and Social Service Specialists"
02,Alaska,212,1240,1193,47,0,22,0,66,60,6,0,3,0,21-2000,Religious Workers
02,Alaska,231,2139,2095,44,0,0,0,72,71,1,0,0,0,23-1000,"Lawyers, Judges, and Related Workers"
02,Alaska,232,701,701,0,0,0,0,24,23,1,0,0,0,23-2000,Legal Support Workers
02,Alaska,251,1764,1451,313,0,0,0,70,55,15,0,0,0,25-1000,Postsecondary Teachers
02,Alaska,252,12338,11622,716,0,60,31,671,641,30,1,2,3,25-2000,"Preschool, Elementary, Middle, Secondary, and Special Education Teachers"
02,Alaska,253,1772,1644,128,0,54,11,94,90,4,0,1,1,25-3000,Other Teachers and Instructors
02,Alaska,254,635,628,7,0,0,0,42,40,2,0,0,0,25-4000,"Librarians, Curators, and Archivists"
02,Alaska,259,4007,3709,298,0,108,4,351,335,16,0,4,1,25-9000,Other Educational Instruction and Library Occupations
02,Alaska,271,1427,1203,224,0,0,0,69,64,5,0,0,0,27-1000,Art and Design Workers
02,Alaska,272,1104,1081,23,0,0,0,62,59,3,0,0,0,27-2000,"Entertainers and Performers, Sports and Related Workers"
02,Alaska,273,2311,2144,167,0,0,65,93,87,6,0,1,1,27-3000,Media and Communication Workers
02,Alaska,274,1034,931,103,0,0,0,20,17,3,0,0,0,27-4000,Media and Communication Equipment Workers
02,Alaska,291,13899,12922,977,0,0,2,505,471,34,0,0,1,29-1000,Healthcare Diagnosing or Treating Practitioners
02,Alaska,292,5147,4290,857,0,122,0,207,188,19,0,1,0,29-2000,Health Technologists and Technicians
02,Alaska,299,187,187,0,0,0,0,10,10,0,0,0,0,29-9000,Other Healthcare Practitioners and Technical Occupations
02,Alaska,3111,6860,5335,1525,0,54,150,379,335,44,0,1,2,31-1100,"Home Health and Personal Care Aides; and Nursing Assistants, Orderlies, and Psychiatric Aides"
02,Alaska,312,102,93,9,0,0,0,15,14,1,0,0,0,31-2000,Occupational Therapy and Physical Therapist Assistants and Aides
02,Alaska,319,3339,2939,400,0,45,0,143,130,13,0,1,0,31-9000,Other Healthcare Support Occupations
02,Alaska,331,874,677,197,0,0,0,55,53,2,0,0,0,33-1000,Supervisors of Protective Service Workers
02,Alaska,332,1091,997,94,0,0,72,97,93,4,0,0,1,33-2000,Firefighting and Prevention Workers
02,Alaska,333,3425,3376,49,0,0,0,196,191,5,0,0,0,33-3000,Law Enforcement Workers
02,Alaska,339,2849,2517,332,0,19,14,159,145,14,0,1,2,33-9000,Other Protective Service Workers
02,Alaska,351,1926,1456,470,0,30,128,85,71,14,0,1,2,35-1000,Supervisors of Food Preparation and Serving Workers
02,Alaska,352,7902,6325,1577,0,16,241,477,409,68,0,1,8,35-2000,Cooks and Food Preparation Workers
02,Alaska,353,5891,5150,741,0,0,56,248,223,25,0,0,1,35-3000,Food and Beverage Serving Workers
02,Alaska,359,2198,1864,334,0,0,108,104,97,7,0,0,3,35-9000,Other Food Preparation and Serving Related Workers
02,Alaska,371,609,499,110,0,0,0,43,38,5,0,0,0,37-1000,Supervisors of Building and Grounds Cleaning and Maintenance Workers
02,Alaska,372,9387,6988,2399,145,18,413,735,640,95,2,1,11,37-2000,Building Cleaning and Pest Control Workers
02,Alaska,373,1116,949,167,0,0,0,85,82,3,0,0,0,37-3000,Grounds Maintenance Workers
02,Alaska,391,50,50,0,0,0,0,6,6,0,0,0,0,39-1000,Supervisors of Personal Care and Service Workers
02,Alaska,392,363,363,0,0,0,0,23,23,0,0,0,0,39-2000,Animal Care and Service Workers
02,Alaska,393,893,893,0,0,0,0,104,102,2,0,0,0,39-3000,Entertainment Attendants and Related Workers
02,Alaska,394,51,51,0,0,0,0,2,2,0,0,0,0,39-4000,Funeral Service Workers
02,Alaska,395,1693,1381,312,47,0,34,73,65,8,1,0,1,39-5000,Personal Appearance Workers
02,Alaska,396,155,124,31,0,0,0,9,8,1,0,0,0,39-6000,"Baggage Porters, Bellhops, and Concierges"
02,Alaska,397,716,665,51,0,0,0,76,74,2,0,0,1,39-7000,Tour and Travel Guides
02,Alaska,399,4339,4057,282,0,0,0,269,250,19,1,0,0,39-9000,Other Personal Care and Service Workers
02,Alaska,411,8337,7423,914,0,46,0,390,353,37,1,3,0,41-1000,Supervisors of Sales Workers
02,Alaska,412,14228,12234,1994,0,92,54,758,686,72,0,2,3,41-2000,Retail Sales Workers
02,Alaska,413,1278,1226,52,0,0,0,56,54,2,0,0,0,41-3000,"Sales Representatives, Services"
02,Alaska,414,1441,1385,56,0,0,41,43,41,2,0,0,1,41-4000,"Sales Representatives, Wholesale and Manufacturing"
02,Alaska,419,1463,1358,105,0,0,0,63,60,3,0,0,0,41-9000,Other Sales and Related Workers
02,Alaska,431,3608,3350,258,0,0,0,161,153,8,0,0,0,43-1000,Supervisors of Office and Administrative Support Workers
02,Alaska,432,209,209,0,0,0,0,8,8,0,0,0,0,43-2000,Communications Equipment Operators
02,Alaska,433,7236,5845,1391,29,0,49,355,321,34,1,0,1,43-3000,Financial Clerks
02,Alaska,434,13141,11945,1196,0,0,156,639,591,48,0,0,5,43-4000,Information and Record Clerks
02,Alaska,435,4988,4521,467,0,0,0,215,191,24,0,0,0,43-5000,"Material Recording, Scheduling, Dispatching, and Distributing Workers"
02,Alaska,436,7224,6877,347,0,0,30,345,332,13,0,0,2,43-6000,Secretaries and Administrative Assistants
02,Alaska,439,6894,5964,930,0,0,135,412,377,35,0,0,1,43-9000,Other Office and Administrative Support Workers
02,Alaska,451,76,76,0,0,0,0,11,11,0,0,0,0,45-1000,"Supervisors of Farming, Fishing, and Forestry Workers"
02,Alaska,452,816,487,329,207,0,4,48,44,4,1,0,1,45-2000,Agricultural Workers
02,Alaska,453,2241,2239,2,0,0,0,402,398,4,0,2,0,45-3000,Fishing and Hunting Workers
02,Alaska,454,249,220,29,0,0,0,47,45,2,0,0,0,45-4000,"Forest, Conservation, and Logging Workers"
02,Alaska,471,2141,2019,122,0,0,0,113,110,3,0,0,0,47-1000,Supervisors of Construction and Extraction Workers
02,Alaska,472,15967,15096,871,16,31,166,1029,998,31,1,1,5,47-2000,Construction Trades Workers
02,Alaska,473,94,94,0,0,0,0,6,6,0,0,0,0,47-3000,"Helpers, Construction Trades"
02,Alaska,474,897,897,0,0,0,0,66,66,0,0,0,0,47-4000,Other Construction and Related Workers
02,Alaska,475,1772,1701,71,0,0,0,107,104,3,0,0,0,47-5000,Extraction Workers
02,Alaska,491,693,591,102,6,0,63,40,35,5,1,0,1,49-1000,"Supervisors of Installation, Maintenance, and Repair Workers"
02,Alaska,492,2013,1970,43,0,0,0,77,74,3,0,0,0,49-2000,"Electrical and Electronic Equipment Mechanics, Installers, and Repairers"
02,Alaska,493,7101,6691,410,0,0,0,252,244,8,0,0,0,49-3000,"Vehicle and Mobile Equipment Mechanics, Installers, and Repairers"
02,Alaska,499,4981,4519,462,0,0,128,283,261,22,0,0,4,49-9000,"Other Installation, Maintenance, and Repair Occupations"
02,Alaska,511,854,609,245,0,0,36,56,34,22,0,0,2,51-1000,Supervisors of Production Workers
02,Alaska,512,147,122,25,0,0,0,11,10,1,0,0,0,51-2000,Assemblers and Fabricators
02,Alaska,513,3468,1332,2136,146,29,92,242,130,112,3,1,6,51-3000,Food Processing Workers
02,Alaska,514,1730,1698,32,0,0,0,75,72,3,0,0,0,51-4000,Metal Workers and Plastic Workers
02,Alaska,5151,227,169,58,0,0,0,11,8,3,0,0,0,51-5100,Printing Workers
02,Alaska,516,917,523,394,0,0,0,49,38,11,0,1,0,51-6000,"Textile, Apparel, and Furnishings Workers"
02,Alaska,517,110,110,0,0,0,0,12,12,0,0,0,0,51-7000,Woodworkers
02,Alaska,518,1433,1307,126,0,0,0,183,175,8,0,0,0,51-8000,Plant and System Operators
02,Alaska,519,3567,3144,423,9,0,25,220,182,38,2,0,3,51-9000,Other Production Occupations
02,Alaska,531,695,617,78,0,0,0,40,37,3,0,0,0,53-1000,Supervisors of Transportation and Material Moving Workers
02,Alaska,532,3326,3172,154,0,0,0,108,104,4,0,0,0,53-2000,Air Transportation Workers
02,Alaska,533,8585,7693,892,0,104,101,387,351,36,0,2,3,53-3000,Motor Vehicle Operators
02,Alaska,534,154,154,0,0,0,0,7,7,0,0,0,0,53-4000,Rail Transportation Workers
02,Alaska,535,1390,1327,63,0,0,0,91,90,1,0,0,0,53-5000,Water Transportation Workers
02,Alaska,536,1339,1068,271,0,35,0,63,57,6,0,1,0,53-6000,Other Transportation Workers
02,Alaska,537,13454,11165,2289,204,21,214,879,785,94,2,2,15,53-7000,Material Moving Workers
04,Arizona,111,40125,35886,4239,34,111,1270,2261,2050,211,2,5,55,11-1000,Top Executives
04,Arizona,112,21033,18952,2081,20,111,534,1161,1047,114,1,4,26,11-2000,"Advertising, Marketing, Promotions, Public Relations, and Sales Managers"
04,Arizona,113,61939,53660,8279,283,307,2820,3395,3010,385,12,14,123,11-3000,Operations Specialties Managers
04,Arizona,119,163666,141811,21855,498,617,9741,8920,7883,1037,21,26,399,11-9000,Other Management Occupations
04,Arizona,131,92266,83594,8672,224,338,2700,5163,4694,469,11,15,125,13-1000,Business Operations Specialists
04,Arizona,132,66017,58535,7482,213,132,2083,3598,3197,401,14,10,104,13-2000,Financial Specialists
04,Arizona,1512,87703,70424,17279,195,349,1893,4836,4000,836,9,23,89,15-1200,Computer Occupations
04,Arizona,152,5143,4253,890,0,17,257,267,234,33,0,1,5,15-2000,Mathematical Science Occupations
04,Arizona,171,4039,3580,459,0,0,52,222,196,26,0,0,3,17-1000,"Architects, Surveyors, and Cartographers"
04,Arizona,172,43067,34014,9053,189,290,1101,2420,1970,450,6,16,53,17-2000,Engineers
04,Arizona,173,13562,11849,1713,89,0,746,750,661,89,4,1,31,17-3000,"Drafters, Engineering Technicians, and Mapping Technicians"
04,Arizona,191,2515,2180,335,19,0,10,180,154,26,1,0,1,19-1000,Life Scientists
04,Arizona,192,5299,3805,1494,6,60,119,319,231,88,1,4,4,19-2000,Physical Scientists
04,Arizona,193,5175,4651,524,0,11,55,302,272,30,0,1,4,19-3000,Social Scientists and Related Workers
04,Arizona,194,6437,5496,941,0,39,327,369,315,54,0,3,18,19-4000,"Life, Physical, and Social Science Technicians"
04,Arizona,195,775,709,66,0,0,12,54,50,4,0,0,1,19-5000,Occupational Health and Safety Specialists and Technicians
04,Arizona,211,39659,35270,4389,121,175,2213,2209,1994,215,10,7,100,21-1000,"Counselors, Social Workers, and Other Community and Social Service Specialists"
04,Arizona,212,7359,6408,951,140,20,154,451,392,59,6,3,11,21-2000,Religious Workers
04,Arizona,231,14342,13347,995,74,79,164,833,777,56,2,4,8,23-1000,"Lawyers, Judges, and Related Workers"
04,Arizona,232,9795,9073,722,0,29,412,556,512,44,0,1,18,23-2000,Legal Support Workers
04,Arizona,251,23339,17949,5390,62,250,360,1426,1128,298,4,15,24,25-1000,Postsecondary Teachers
04,Arizona,252,90126,82117,8009,227,708,2733,5589,5138,451,12,32,148,25-2000,"Preschool, Elementary, Middle, Secondary, and Special Education Teachers"
04,Arizona,253,17992,16307,1685,11,80,524,1114,1006,108,2,8,24,25-3000,Other Teachers and Instructors
04,Arizona,254,4493,4265,228,0,17,150,286,269,17,0,1,7,25-4000,"Librarians, Curators, and Archivists"
04,Arizona,259,23617,19709,3908,130,161,1790,1565,1330,235,7,12,105,25-9000,Other Educational Instruction and Library Occupations
04,Arizona,271,18957,16540,2417,121,55,493,1101,970,131,5,4,29,27-1000,Art and Design Workers
04,Arizona,272,12710,11520,1190,33,93,604,871,807,64,2,3,26,27-2000,"Entertainers and Performers, Sports and Related Workers"
04,Arizona,273,13847,11720,2127,14,89,967,814,694,120,1,8,44,27-3000,Media and Communication Workers
04,Arizona,274,5966,5556,410,12,113,168,395,363,32,1,5,10,27-4000,Media and Communication Equipment Workers
04,Arizona,291,115017,97293,17724,362,478,1844,6290,5409,881,20,32,82,29-1000,Healthcare Diagnosing or Treating Practitioners
04,Arizona,292,52652,46125,6527,99,132,2093,2763,2456,307,4,7,90,29-2000,Health Technologists and Technicians
04,Arizona,299,1804,1657,147,0,23,29,93,86,7,0,1,2,29-9000,Other Healthcare Practitioners and Technical Occupations
04,Arizona,3111,54998,41771,13227,314,221,6135,3049,2435,614,17,14,269,31-1100,"Home Health and Personal Care Aides; and Nursing Assistants, Orderlies, and Psychiatric Aides"
04,Arizona,312,2626,2370,256,28,25,72,162,146,16,1,2,5,31-2000,Occupational Therapy and Physical Therapist Assistants and Aides
04,Arizona,319,36478,32019,4459,198,63,2606,1849,1633,216,9,6,106,31-9000,Other Healthcare Support Occupations
04,Arizona,331,7101,6959,142,0,0,12,431,418,13,0,0,4,33-1000,Supervisors of Protective Service Workers
04,Arizona,332,6915,6828,87,0,0,12,424,418,6,0,0,1,33-2000,Firefighting and Prevention Workers
04,Arizona,333,30734,28328,2406,43,101,1518,1602,1487,115,3,5,61,33-3000,Law Enforcement Workers
04,Arizona,339,28932,26270,2662,18,27,1389,1711,1581,130,1,3,52,33-9000,Other Protective Service Workers
04,Arizona,351,21407,16516,4891,179,69,2987,1010,812,198,6,3,105,35-1000,Supervisors of Food Preparation and Serving Workers
04,Arizona,352,71359,51182,20177,1038,250,15417,3889,3016,873,54,13,580,35-2000,Cooks and Food Preparation Workers
04,Arizona,353,76290,66227,10063,355,145,5740,4055,3573,482,9,12,242,35-3000,Food and Beverage Serving Workers
04,Arizona,359,24102,19780,4322,139,81,3072,1568,1365,203,8,5,129,35-9000,Other Food Preparation and Serving Related Workers
04,Arizona,371,9841,6763,3078,19,115,2576,446,322,124,2,6,96,37-1000,Supervisors of Building and Grounds Cleaning and Maintenance Workers
04,Arizona,372,85370,49711,35659,1714,687,30106,4615,3071,1544,73,35,1260,37-2000,Building Cleaning and Pest Control Workers
04,Arizona,373,40189,17935,22254,1317,30,20362,1862,1104,758,42,2,681,37-3000,Grounds Maintenance Workers
04,Arizona,391,2623,2222,401,18,0,123,128,104,24,2,0,8,39-1000,Supervisors of Personal Care and Service Workers
04,Arizona,392,7417,7012,405,25,22,237,402,379,23,2,2,13,39-2000,Animal Care and Service Workers
04,Arizona,393,8035,7430,605,0,0,263,471,426,45,0,1,16,39-3000,Entertainment Attendants and Related Workers
04,Arizona,394,379,320,59,0,0,59,25,22,3,0,0,2,39-4000,Funeral Service Workers
04,Arizona,395,26231,18642,7589,57,209,1714,1261,893,368,4,8,77,39-5000,Personal Appearance Workers
04,Arizona,396,1873,1751,122,0,0,0,90,84,6,0,0,0,39-6000,"Baggage Porters, Bellhops, and Concierges"
04,Arizona,397,1916,1836,80,40,0,0,149,137,12,8,0,0,39-7000,Tour and Travel Guides
04,Arizona,399,36595,30633,5962,179,122,3783,2314,1997,317,11,10,191,39-9000,Other Personal Care and Service Workers
04,Arizona,411,85941,75806,10135,467,300,5233,4416,3936,480,14,10,221,41-1000,Supervisors of Sales Workers
04,Arizona,412,128635,112765,15870,554,282,9250,7860,6998,862,25,12,453,41-2000,Retail Sales Workers
04,Arizona,413,40242,36760,3482,44,255,1429,2152,1990,162,2,12,57,41-3000,"Sales Representatives, Services"
04,Arizona,414,24023,21752,2271,118,116,1031,1319,1196,123,8,8,45,41-4000,"Sales Representatives, Wholesale and Manufacturing"
04,Arizona,419,35114,31482,3632,74,61,1618,2073,1864,209,4,5,84,41-9000,Other Sales and Related Workers
04,Arizona,431,27155,24151,3004,37,204,1590,1504,1344,160,3,8,78,43-1000,Supervisors of Office and Administrative Support Workers
04,Arizona,432,2213,2050,163,14,33,101,121,113,8,1,2,4,43-2000,Communications Equipment Operators
04,Arizona,433,52639,47176,5463,303,170,2449,2861,2573,288,14,8,129,43-3000,Financial Clerks
04,Arizona,434,149095,134218,14877,494,307,9189,8126,7347,779,29,20,430,43-4000,Information and Record Clerks
04,Arizona,435,42067,36691,5376,213,269,2834,2232,1979,253,10,8,129,43-5000,"Material Recording, Scheduling, Dispatching, and Distributing Workers"
04,Arizona,436,48849,44745,4104,183,151,2473,3051,2829,222,8,12,109,43-6000,Secretaries and Administrative Assistants
04,Arizona,439,62415,55619,6796,273,152,3670,3584,3215,369,14,9,180,43-9000,Other Office and Administrative Support Workers
04,Arizona,451,1556,850,706,0,0,706,70,39,31,0,0,30,45-1000,"Supervisors of Farming, Fishing, and Forestry Workers"
04,Arizona,452,14485,5651,8834,646,0,8123,881,424,457,38,0,413,45-2000,Agricultural Workers
04,Arizona,453,111,111,0,0,0,0,19,19,0,0,0,0,45-3000,Fishing and Hunting Workers
04,Arizona,454,622,572,50,0,0,50,46,44,2,0,0,2,45-4000,"Forest, Conservation, and Logging Workers"
04,Arizona,471,16280,12361,3919,59,50,3542,846,691,155,3,2,131,47-1000,Supervisors of Construction and Extraction Workers
04,Arizona,472,132617,83145,49472,2634,252,44248,6462,4640,1822,86,9,1592,47-2000,Construction Trades Workers
04,Arizona,473,763,564,199,10,0,176,51,43,8,1,0,6,47-3000,"Helpers, Construction Trades"
04,Arizona,474,6154,4679,1475,59,37,1206,342,285,57,2,2,46,47-4000,Other Construction and Related Workers
04,Arizona,475,3507,3034,473,0,0,473,188,171,17,0,0,17,47-5000,Extraction Workers
04,Arizona,491,5454,4760,694,30,0,507,293,258,35,2,0,24,49-1000,"Supervisors of Installation, Maintenance, and Repair Workers"
04,Arizona,492,9717,8166,1551,14,21,902,497,446,51,1,1,26,49-2000,"Electrical and Electronic Equipment Mechanics, Installers, and Repairers"
04,Arizona,493,39464,31999,7465,296,45,6112,1886,1606,280,9,3,222,49-3000,"Vehicle and Mobile Equipment Mechanics, Installers, and Repairers"
04,Arizona,499,42005,35057,6948,268,57,5155,2099,1813,286,11,3,206,49-9000,"Other Installation, Maintenance, and Repair Occupations"
04,Arizona,511,10576,8764,1812,57,10,1243,604,512,92,3,1,56,51-1000,Supervisors of Production Workers
04,Arizona,512,14440,9267,5173,79,24,2903,744,509,235,5,2,114,51-2000,Assemblers and Fabricators
04,Arizona,513,12635,8642,3993,113,0,2747,577,423,154,5,2,109,51-3000,Food Processing Workers
04,Arizona,514,22824,17103,5721,125,13,4378,1167,948,219,7,1,148,51-4000,Metal Workers and Plastic Workers
04,Arizona,5151,2634,2244,390,0,0,269,155,128,27,0,0,18,51-5100,Printing Workers
04,Arizona,516,8139,4138,4001,128,53,2963,439,249,190,8,3,130,51-6000,"Textile, Apparel, and Furnishings Workers"
04,Arizona,517,2427,1751,676,30,17,563,121,98,23,2,1,17,51-7000,Woodworkers
04,Arizona,518,5167,4654,513,0,0,242,269,247,22,0,0,7,51-8000,Plant and System Operators
04,Arizona,519,42842,32046,10796,277,149,7574,2253,1762,491,16,8,315,51-9000,Other Production Occupations
04,Arizona,531,4460,3835,625,0,0,521,224,192,32,0,1,25,53-1000,Supervisors of Transportation and Material Moving Workers
04,Arizona,532,10081,9069,1012,0,59,195,601,549,52,2,4,11,53-2000,Air Transportation Workers
04,Arizona,533,79770,63015,16755,733,386,10742,4321,3573,748,27,20,448,53-3000,Motor Vehicle Operators
04,Arizona,534,1774,1667,107,0,0,95,116,110,6,0,0,4,53-4000,Rail Transportation Workers
04,Arizona,535,109,109,0,0,0,0,18,17,1,0,0,0,53-5000,Water Transportation Workers
04,Arizona,536,6254,5586,668,70,0,474,316,283,33,2,1,21,53-6000,Other Transportation Workers
04,Arizona,537,105392,84405,20987,1370,291,15435,5795,4813,982,58,12,698,53-7000,Material Moving Workers
05,Arkansas,111,12217,11887,330,64,0,40,684,668,16,2,0,2,11-1000,Top Executives
05,Arkansas,112,5769,5614,155,20,17,0,300,289,11,2,1,0,11-2000,"Advertising, Marketing, Promotions, Public Relations, and Sales Managers"
05,Arkansas,113,19629,18684,945,95,12,258,1059,1016,43,2,1,10,11-3000,Operations Specialties Managers
05,Arkansas,119,70114,66516,3598,142,272,1192,3740,3593,147,7,8,47,11-9000,Other Management Occupations
05,Arkansas,131,28081,26656,1425,94,16,454,1493,1438,55,2,4,18,13-1000,Business Operations Specialists
05,Arkansas,132,18765,17966,799,0,5,76,1059,1025,34,0,1,4,13-2000,Financial Specialists
05,Arkansas,1512,21580,18153,3427,150,61,169,1117,985,132,6,3,8,15-1200,Computer Occupations
05,Arkansas,152,1126,858,268,0,0,0,59,52,7,0,0,0,15-2000,Mathematical Science Occupations
05,Arkansas,171,836,798,38,0,0,0,42,41,1,0,0,0,17-1000,"Architects, Surveyors, and Cartographers"
05,Arkansas,172,8634,7535,1099,0,0,53,438,405,33,0,0,2,17-2000,Engineers
05,Arkansas,173,5107,4776,331,0,35,140,294,279,15,0,1,6,17-3000,"Drafters, Engineering Technicians, and Mapping Technicians"
05,Arkansas,191,1667,1118,549,29,0,0,93,78,15,1,0,0,19-1000,Life Scientists
05,Arkansas,192,1303,1043,260,21,48,0,67,53,14,1,2,0,19-2000,Physical Scientists
05,Arkansas,193,1352,1305,47,0,0,0,59,57,2,0,0,0,19-3000,Social Scientists and Related Workers
05,Arkansas,194,3012,2463,549,13,22,251,167,154,13,1,1,4,19-4000,"Life, Physical, and Social Science Technicians"
05,Arkansas,195,564,564,0,0,0,0,30,30,0,0,0,0,19-5000,Occupational Health and Safety Specialists and Technicians
05,Arkansas,211,14618,14369,249,43,11,77,739,724,15,3,1,4,21-1000,"Counselors, Social Workers, and Other Community and Social Service Specialists"
05,Arkansas,212,6891,6431,460,92,0,161,400,382,18,2,0,6,21-2000,Religious Workers
05,Arkansas,231,5209,5147,62,33,0,0,249,246,3,2,0,0,23-1000,"Lawyers, Judges, and Related Workers"
05,Arkansas,232,2900,2853,47,0,0,0,164,163,1,0,0,0,23-2000,Legal Support Workers
05,Arkansas,251,10706,9401,1305,0,108,25,573,504,69,0,8,1,25-1000,Postsecondary Teachers
05,Arkansas,252,49566,48565,1001,187,84,306,2996,2951,45,4,5,8,25-2000,"Preschool, Elementary, Middle, Secondary, and Special Education Teachers"
05,Arkansas,253,6421,6038,383,61,30,126,424,408,16,5,1,2,25-3000,Other Teachers and Instructors
05,Arkansas,254,2269,2164,105,0,21,0,135,129,6,0,2,0,25-4000,"Librarians, Curators, and Archivists"
05,Arkansas,259,11272,10865,407,28,25,214,724,700,24,3,1,12,25-9000,Other Educational Instruction and Library Occupations
05,Arkansas,271,5540,5279,261,0,0,12,303,294,9,0,0,1,27-1000,Art and Design Workers
05,Arkansas,272,3696,3407,289,30,6,18,274,254,20,1,4,3,27-2000,"Entertainers and Performers, Sports and Related Workers"
05,Arkansas,273,4358,3970,388,77,84,137,243,230,13,3,2,4,27-3000,Media and Communication Workers
05,Arkansas,274,1928,1888,40,11,0,0,112,108,4,2,0,0,27-4000,Media and Communication Equipment Workers
05,Arkansas,291,53176,50795,2381,136,25,167,2779,2667,112,6,2,7,29-1000,Healthcare Diagnosing or Treating Practitioners
05,Arkansas,292,29427,28615,812,86,42,178,1603,1566,37,6,2,9,29-2000,Health Technologists and Technicians
05,Arkansas,299,648,617,31,0,0,0,32,31,1,0,0,0,29-9000,Other Healthcare Practitioners and Technical Occupations
05,Arkansas,3111,30441,29231,1210,33,3,279,1805,1757,48,3,1,14,31-1100,"Home Health and Personal Care Aides; and Nursing Assistants, Orderlies, and Psychiatric Aides"
05,Arkansas,312,1328,1302,26,0,0,0,93,91,2,0,0,0,31-2000,Occupational Therapy and Physical Therapist Assistants and Aides
05,Arkansas,319,9946,9771,175,27,0,95,479,464,15,2,1,6,31-9000,Other Healthcare Support Occupations
05,Arkansas,331,2609,2569,40,0,0,0,160,158,2,0,0,0,33-1000,Supervisors of Protective Service Workers
05,Arkansas,332,2794,2794,0,0,0,0,150,150,0,0,0,0,33-2000,Firefighting and Prevention Workers
05,Arkansas,333,12435,12099,336,43,0,260,626,618,8,2,0,5,33-3000,Law Enforcement Workers
05,Arkansas,339,7446,7385,61,19,16,0,464,458,6,2,1,0,33-9000,Other Protective Service Workers
05,Arkansas,351,7087,6341,746,119,0,338,356,327,29,5,0,10,35-1000,Supervisors of Food Preparation and Serving Workers
05,Arkansas,352,29748,27057,2691,556,0,1531,1840,1740,100,18,0,48,35-2000,Cooks and Food Preparation Workers
05,Arkansas,353,24231,22749,1482,211,50,1002,1527,1454,73,11,4,37,35-3000,Food and Beverage Serving Workers
05,Arkansas,359,6146,5623,523,28,27,369,411,388,23,1,1,13,35-9000,Other Food Preparation and Serving Related Workers
05,Arkansas,371,3228,3163,65,55,0,0,162,156,6,3,1,1,37-1000,Supervisors of Building and Grounds Cleaning and Maintenance Workers
05,Arkansas,372,33658,28905,4753,1388,140,2656,2109,1900,209,44,4,125,37-2000,Building Cleaning and Pest Control Workers
05,Arkansas,373,11989,9942,2047,250,0,1723,656,589,67,11,0,53,37-3000,Grounds Maintenance Workers
05,Arkansas,391,675,594,81,0,0,0,24,23,1,0,0,0,39-1000,Supervisors of Personal Care and Service Workers
05,Arkansas,392,1702,1663,39,0,0,39,130,126,4,0,0,3,39-2000,Animal Care and Service Workers
05,Arkansas,393,1457,1439,18,0,0,18,115,110,5,0,1,1,39-3000,Entertainment Attendants and Related Workers
05,Arkansas,394,851,851,0,0,0,0,48,47,1,0,0,0,39-4000,Funeral Service Workers
05,Arkansas,395,8866,7183,1683,23,12,400,414,363,51,1,2,6,39-5000,Personal Appearance Workers
05,Arkansas,396,165,165,0,0,0,0,4,4,0,0,0,0,39-6000,"Baggage Porters, Bellhops, and Concierges"
05,Arkansas,397,257,257,0,0,0,0,31,31,0,0,0,0,39-7000,Tour and Travel Guides
05,Arkansas,399,13782,13241,541,25,5,318,956,922,34,3,1,17,39-9000,Other Personal Care and Service Workers
05,Arkansas,411,42108,39867,2241,305,47,666,2149,2069,80,7,3,22,41-1000,Supervisors of Sales Workers
05,Arkansas,412,56325,53992,2333,201,59,881,3608,3503,105,10,4,31,41-2000,Retail Sales Workers
05,Arkansas,413,10083,9823,260,10,0,87,540,524,16,1,0,6,41-3000,"Sales Representatives, Services"
05,Arkansas,414,10414,10153,261,16,0,98,554,538,16,2,0,6,41-4000,"Sales Representatives, Wholesale and Manufacturing"
05,Arkansas,419,8780,8439,341,23,20,157,468,452,16,1,2,5,41-9000,Other Sales and Related Workers
05,Arkansas,431,9726,9459,267,32,37,106,599,587,12,1,2,3,43-1000,Supervisors of Office and Administrative Support Workers
05,Arkansas,432,642,642,0,0,0,0,40,40,0,0,0,0,43-2000,Communications Equipment Operators
05,Arkansas,433,22181,21749,432,58,0,175,1258,1232,26,1,0,10,43-3000,Financial Clerks
05,Arkansas,434,36797,35150,1647,195,82,657,2071,1998,73,5,3,30,43-4000,Information and Record Clerks
05,Arkansas,435,19051,18406,645,138,0,310,1090,1068,22,4,0,10,43-5000,"Material Recording, Scheduling, Dispatching, and Distributing Workers"
05,Arkansas,436,25934,25350,584,81,97,161,1685,1646,39,3,5,12,43-6000,Secretaries and Administrative Assistants
05,Arkansas,439,19526,18751,775,107,0,359,1281,1241,40,5,0,13,43-9000,Other Office and Administrative Support Workers
05,Arkansas,451,936,919,17,0,0,17,49,48,1,0,0,1,45-1000,"Supervisors of Farming, Fishing, and Forestry Workers"
05,Arkansas,452,11266,9328,1938,173,19,1512,772,692,80,9,2,59,45-2000,Agricultural Workers
05,Arkansas,453,23,23,0,0,0,0,7,7,0,0,0,0,45-3000,Fishing and Hunting Workers
05,Arkansas,454,2754,2377,377,56,0,317,151,137,14,1,0,12,45-4000,"Forest, Conservation, and Logging Workers"
05,Arkansas,471,6896,6319,577,102,9,441,402,385,17,4,1,11,47-1000,Supervisors of Construction and Extraction Workers
05,Arkansas,472,55202,44957,10245,2376,0,7624,2851,2560,291,56,0,223,47-2000,Construction Trades Workers
05,Arkansas,473,142,96,46,37,0,9,16,13,3,1,0,2,47-3000,"Helpers, Construction Trades"
05,Arkansas,474,3164,3042,122,46,0,76,164,159,5,1,0,4,47-4000,Other Construction and Related Workers
05,Arkansas,475,2114,1919,195,0,0,90,136,130,6,0,0,5,47-5000,Extraction Workers
05,Arkansas,491,3420,3335,85,0,0,34,170,166,4,0,0,1,49-1000,"Supervisors of Installation, Maintenance, and Repair Workers"
05,Arkansas,492,4035,3977,58,0,0,58,231,228,3,0,0,2,49-2000,"Electrical and Electronic Equipment Mechanics, Installers, and Repairers"
05,Arkansas,493,15937,15226,711,106,0,551,939,908,31,4,0,23,49-3000,"Vehicle and Mobile Equipment Mechanics, Installers, and Repairers"
05,Arkansas,499,23638,22360,1278,374,0,469,1338,1292,46,10,0,20,49-9000,"Other Installation, Maintenance, and Repair Occupations"
05,Arkansas,511,11118,9592,1526,272,95,761,637,575,62,10,4,28,51-1000,Supervisors of Production Workers
05,Arkansas,512,10520,9079,1441,129,0,712,625,571,54,6,0,21,51-2000,Assemblers and Fabricators
05,Arkansas,513,13340,9460,3880,825,53,2230,598,469,129,24,1,70,51-3000,Food Processing Workers
05,Arkansas,514,19350,18064,1286,258,18,806,1119,1062,57,11,1,35,51-4000,Metal Workers and Plastic Workers
05,Arkansas,5151,1489,1408,81,14,0,52,104,99,5,1,0,3,51-5100,Printing Workers
05,Arkansas,516,3240,2760,480,107,0,216,216,192,24,5,0,10,51-6000,"Textile, Apparel, and Furnishings Workers"
05,Arkansas,517,2209,2066,143,103,0,40,118,113,5,3,0,2,51-7000,Woodworkers
05,Arkansas,518,3672,3468,204,0,0,36,204,198,6,0,0,2,51-8000,Plant and System Operators
05,Arkansas,519,43739,34780,8959,2969,44,4525,2431,2122,309,85,2,160,51-9000,Other Production Occupations
05,Arkansas,531,2486,2448,38,0,0,38,122,119,3,0,0,3,53-1000,Supervisors of Transportation and Material Moving Workers
05,Arkansas,532,1425,1407,18,0,0,0,82,81,1,0,0,0,53-2000,Air Transportation Workers
05,Arkansas,533,43064,41262,1802,420,0,716,2380,2317,63,16,1,23,53-3000,Motor Vehicle Operators
05,Arkansas,534,1011,1011,0,0,0,0,74,73,1,0,0,1,53-4000,Rail Transportation Workers
05,Arkansas,535,721,721,0,0,0,0,55,55,0,0,0,0,53-5000,Water Transportation Workers
05,Arkansas,536,1787,1751,36,0,0,36,94,93,1,0,0,1,53-6000,Other Transportation Workers
05,Arkansas,537,58659,51613,7046,1555,130,3798,3425,3145,280,58,7,152,53-7000,Material Moving Workers
06,California,111,269624,198538,71086,2152,2164,10582,14894,11054,3840,107,125,491,11-1000,Top Executives
06,California,112,152889,121416,31473,1159,1657,3583,8362,6610,1752,60,89,160,11-2000,"Advertising, Marketing, Promotions, Public Relations, and Sales Managers"
06,California,113,346970,247820,99150,5362,3439,15250,19680,14040,5640,267,179,804,11-3000,Operations Specialties Managers
06,California,119,1049675,762320,287355,15765,10153,74134,57284,42154,15130,755,500,3387,11-9000,Other Management Occupations
06,California,131,566451,435600,130851,5493,4260,21295,32200,24672,7528,286,270,1094,13-1000,Business Operations Specialists
06,California,132,389704,262412,127292,4153,3627,13060,21854,14433,7421,221,201,699,13-2000,Financial Specialists
06,California,1512,628079,352911,275168,3608,5892,11625,34586,20005,14581,192,315,578,15-1200,Computer Occupations
06,California,152,35021,24307,10714,250,260,470,2006,1414,592,12,15,38,15-2000,Mathematical Science Occupations
06,California,171,31431,21763,9668,203,614,693,1744,1231,513,12,32,32,17-1000,"Architects, Surveyors, and Cartographers"
06,California,172,290159,166147,124012,2103,3070,6866,16173,9416,6757,91,158,334,17-2000,Engineers
06,California,173,68116,44940,23176,974,509,5220,4055,2622,1433,58,31,273,17-3000,"Drafters, Engineering Technicians, and Mapping Technicians"
06,California,191,35166,21610,13556,95,374,426,2083,1298,785,8,23,22,19-1000,Life Scientists
06,California,192,69892,40458,29434,199,808,626,3979,2304,1675,13,44,35,19-2000,Physical Scientists
06,California,193,41800,35393,6407,304,431,737,2412,2021,391,20,24,42,19-3000,Social Scientists and Related Workers
06,California,194,40669,29400,11269,488,262,2217,2534,1860,674,35,16,124,19-4000,"Life, Physical, and Social Science Technicians"
06,California,195,6158,5149,1009,87,0,316,340,283,57,5,0,10,19-5000,Occupational Health and Safety Specialists and Technicians
06,California,211,232245,189722,42523,3787,1799,14793,12722,10352,2370,211,111,754,21-1000,"Counselors, Social Workers, and Other Community and Social Service Specialists"
06,California,212,45590,32253,13337,1203,587,2295,2900,1999,901,60,39,128,21-2000,Religious Workers
06,California,231,135373,115574,19799,537,683,1084,7716,6587,1129,25,40,56,23-1000,"Lawyers, Judges, and Related Workers"
06,California,232,62861,50734,12127,963,639,2872,3572,2873,699,48,31,153,23-2000,Legal Support Workers
06,California,251,136383,98279,38104,460,2211,2390,8696,6261,2435,33,132,148,25-1000,Postsecondary Teachers
06,California,252,515566,431498,84068,6222,3811,24507,30835,25749,5086,346,223,1368,25-2000,"Preschool, Elementary, Middle, Secondary, and Special Education Teachers"
06,California,253,117691,92994,24697,970,1047,5078,7939,6214,1725,55,77,274,25-3000,Other Teachers and Instructors
06,California,254,25877,21571,4306,94,132,846,1715,1431,284,5,9,43,25-4000,"Librarians, Curators, and Archivists"
06,California,259,146282,111121,35161,2854,1383,14012,9250,7052,2198,190,84,814,25-9000,Other Educational Instruction and Library Occupations
06,California,271,187278,136518,50760,2036,2466,9123,10863,7961,2902,113,142,451,27-1000,Art and Design Workers
06,California,272,141709,118407,23302,810,1181,4183,9112,7686,1426,50,75,207,27-2000,"Entertainers and Performers, Sports and Related Workers"
06,California,273,119339,97505,21834,1127,1363,4056,7536,6096,1440,71,90,225,27-3000,Media and Communication Workers
06,California,274,62553,51672,10881,443,812,1600,3842,3201,641,27,38,96,27-4000,Media and Communication Equipment Workers
06,California,291,608670,404266,204404,4936,5268,12411,33196,22167,11029,249,276,627,29-1000,Healthcare Diagnosing or Treating Practitioners
06,California,292,271047,192649,78398,5486,1990,14519,13873,9705,4168,267,110,705,29-2000,Health Technologists and Technicians
06,California,299,7358,5853,1505,59,0,321,429,348,81,4,1,14,29-9000,Other Healthcare Practitioners and Technical Occupations
06,California,3111,423681,228845,194836,18781,4396,57086,22341,11906,10435,987,227,2946,31-1100,"Home Health and Personal Care Aides; and Nursing Assistants, Orderlies, and Psychiatric Aides"
06,California,312,10318,8315,2003,94,79,504,605,481,124,8,6,21,31-2000,Occupational Therapy and Physical Therapist Assistants and Aides
06,California,319,189944,134896,55048,4485,1767,19932,9781,6910,2871,237,94,909,31-9000,Other Healthcare Support Occupations
06,California,331,31221,27920,3301,211,147,1398,1806,1636,170,11,5,68,33-1000,Supervisors of Protective Service Workers
06,California,332,33561,31750,1811,219,235,543,1871,1765,106,10,7,42,33-2000,Firefighting and Prevention Workers
06,California,333,130084,115105,14979,1646,385,5298,6830,6034,796,78,25,289,33-3000,Law Enforcement Workers
06,California,339,165697,134518,31179,2860,685,10442,9097,7501,1596,152,36,496,33-9000,Other Protective Service Workers
06,California,351,132295,76816,55479,5462,1082,24467,6423,3813,2610,229,49,1034,35-1000,Supervisors of Food Preparation and Serving Workers
06,California,352,404757,205682,199075,25178,2391,128366,20875,11832,9043,1075,133,5293,35-2000,Cooks and Food Preparation Workers
06,California,353,388880,285304,103576,8099,2382,44269,20779,15446,5333,376,140,1992,35-3000,Food and Beverage Serving Workers
06,California,359,122570,77902,44668,6259,1214,27749,6874,4800,2074,265,56,1177,35-9000,Other Food Preparation and Serving Related Workers
06,California,371,40717,20941,19776,2329,461,14585,1887,1054,833,105,18,583,37-1000,Supervisors of Building and Grounds Cleaning and Maintenance Workers
06,California,372,487478,174795,312683,70104,7874,196146,25092,10261,14831,3188,383,9088,37-2000,Building Cleaning and Pest Control Workers
06,California,373,193179,65798,127381,17385,1182,104062,8661,3725,4936,625,45,3972,37-3000,Grounds Maintenance Workers
06,California,391,15673,10813,4860,266,17,955,736,507,229,11,2,41,39-1000,Supervisors of Personal Care and Service Workers
06,California,392,37082,31935,5147,469,134,2557,2168,1877,291,25,11,125,39-2000,Animal Care and Service Workers
06,California,393,53447,40441,13006,651,310,2294,3233,2501,732,28,14,119,39-3000,Entertainment Attendants and Related Workers
06,California,394,3455,2673,782,161,22,293,184,150,34,6,2,9,39-4000,Funeral Service Workers
06,California,395,165209,93362,71847,2424,995,13137,8510,4624,3886,124,50,643,39-5000,Personal Appearance Workers
06,California,396,7554,5343,2211,314,171,642,373,264,109,14,3,32,39-6000,"Baggage Porters, Bellhops, and Concierges"
06,California,397,7233,5471,1762,14,23,108,472,372,100,1,2,4,39-7000,Tour and Travel Guides
06,California,399,241236,164739,76497,12965,4151,32835,15056,10689,4367,639,253,1812,39-9000,Other Personal Care and Service Workers
06,California,411,462618,328421,134197,9422,3982,40302,23758,16946,6812,438,205,1869,41-1000,Supervisors of Sales Workers
06,California,412,817222,599117,218105,21211,5498,91449,47558,35719,11839,1025,311,4532,41-2000,Retail Sales Workers
06,California,413,182506,143178,39328,2575,2121,7217,9723,7644,2079,120,98,365,41-3000,"Sales Representatives, Services"
06,California,414,155212,118339,36873,1948,1314,11867,8335,6339,1996,104,63,598,41-4000,"Sales Representatives, Wholesale and Manufacturing"
06,California,419,175366,129238,46128,2760,2096,12439,10077,7406,2671,145,108,657,41-9000,Other Sales and Related Workers
06,California,431,143316,108763,34553,2648,1069,9863,8276,6301,1975,153,61,536,43-1000,Supervisors of Office and Administrative Support Workers
06,California,432,7671,6076,1595,115,18,463,474,370,104,8,5,30,43-2000,Communications Equipment Operators
06,California,433,256329,190149,66180,4813,2424,18794,14877,10976,3901,255,119,975,43-3000,Financial Clerks
06,California,434,610629,475755,134874,11939,4229,47599,34410,26716,7694,644,244,2463,43-4000,Information and Record Clerks
06,California,435,249942,170592,79350,7262,2018,33555,13694,9394,4300,376,100,1635,43-5000,"Material Recording, Scheduling, Dispatching, and Distributing Workers"
06,California,436,287067,227612,59455,4139,2248,19473,18011,14303,3708,259,142,1123,43-6000,Secretaries and Administrative Assistants
06,California,439,381779,290375,91404,7236,3313,28817,22597,17133,5464,416,177,1555,43-9000,Other Office and Administrative Support Workers
06,California,451,13780,4272,9508,128,27,9141,674,258,416,9,1,390,45-1000,"Supervisors of Farming, Fishing, and Forestry Workers"
06,California,452,256982,51619,205363,9908,386,189787,13239,3416,9823,480,26,9021,45-2000,Agricultural Workers
06,California,453,1991,1716,275,0,24,128,127,112,15,0,1,5,45-3000,Fishing and Hunting Workers
06,California,454,4497,3002,1495,138,0,1313,294,237,57,5,0,44,45-4000,"Forest, Conservation, and Logging Workers"
06,California,471,76585,53310,23275,2160,614,16794,3941,2817,1124,99,34,776,47-1000,Supervisors of Construction and Extraction Workers
06,California,472,756893,380631,376262,62713,5205,269705,35454,19807,15647,2502,223,10794,47-2000,Construction Trades Workers
06,California,473,3825,1858,1967,258,17,1463,202,125,77,13,1,52,47-3000,"Helpers, Construction Trades"
06,California,474,33626,24233,9393,1130,166,5968,1704,1293,411,44,10,230,47-4000,Other Construction and Related Workers
06,California,475,8878,7078,1800,205,39,1423,467,387,80,7,3,57,47-5000,Extraction Workers
06,California,491,20532,15250,5282,594,64,3186,1152,875,277,27,7,153,49-1000,"Supervisors of Installation, Maintenance, and Repair Workers"
06,California,492,57284,40750,16534,1787,192,5912,2951,2120,831,77,18,255,49-2000,"Electrical and Electronic Equipment Mechanics, Installers, and Repairers"
06,California,493,195183,120846,74337,10155,1323,42965,9359,5870,3489,448,68,1855,49-3000,"Vehicle and Mobile Equipment Mechanics, Installers, and Repairers"
06,California,499,201045,136086,64959,8369,1236,35424,10204,7071,3133,378,65,1603,49-9000,"Other Installation, Maintenance, and Repair Occupations"
06,California,511,75884,44524,31360,2652,568,19159,4120,2407,1713,147,27,987,51-1000,Supervisors of Production Workers
06,California,512,110305,42547,67758,5549,635,31652,6018,2393,3625,265,36,1526,51-2000,Assemblers and Fabricators
06,California,513,83785,41189,42596,4533,454,28344,4093,2045,2048,206,29,1270,51-3000,Food Processing Workers
06,California,514,129182,62786,66396,6387,1122,42254,6481,3205,3276,292,52,1975,51-4000,Metal Workers and Plastic Workers
06,California,5151,20484,11718,8766,1023,93,4712,1082,648,434,48,6,216,51-5100,Printing Workers
06,California,516,81579,17301,64278,13317,819,37935,4484,1010,3474,652,46,1949,51-6000,"Textile, Apparel, and Furnishings Workers"
06,California,517,10747,5856,4891,660,16,3467,576,339,237,27,4,153,51-7000,Woodworkers
06,California,518,24941,19394,5547,394,182,2178,1332,1042,290,25,10,97,51-8000,Plant and System Operators
06,California,519,314670,155141,159529,17006,2460,94970,16920,8487,8433,820,139,4746,51-9000,Other Production Occupations
06,California,531,27146,19147,7999,1211,167,4135,1399,973,426,54,12,210,53-1000,Supervisors of Transportation and Material Moving Workers
06,California,532,28887,24070,4817,195,415,351,1523,1269,254,9,17,15,53-2000,Air Transportation Workers
06,California,533,523237,292509,230728,34710,6159,108211,25594,14947,10647,1553,280,4922,53-3000,Motor Vehicle Operators
06,California,534,7230,6368,862,223,26,359,361,321,40,9,1,19,53-4000,Rail Transportation Workers
06,California,535,3611,3155,456,13,0,72,220,192,28,2,0,4,53-5000,Water Transportation Workers
06,California,536,29532,19541,9991,2111,373,3492,1584,1084,500,102,18,168,53-6000,Other Transportation Workers
06,California,537,673327,420945,252382,32846,4126,169676,36643,24020,12623,1558,213,8088,53-7000,Material Moving Workers
08,Colorado,111,49977,46586,3391,132,174,391,2668,2513,155,2,10,16,11-1000,Top Executives
08,Colorado,112,25306,23656,1650,12,329,122,1373,1290,83,1,14,6,11-2000,"Advertising, Marketing, Promotions, Public Relations, and Sales Managers"
08,Colorado,113,62439,56742,5697,149,406,1061,3467,3205,262,6,16,38,11-3000,Operations Specialties Managers
08,Colorado,119,192979,178647,14332,574,762,4339,10816,10118,698,16,44,159,11-9000,Other Management Occupations
08,Colorado,131,103839,96912,6927,173,398,1195,5810,5434,376,9,27,50,13-1000,Business Operations Specialists
08,Colorado,132,65788,60410,5378,122,304,764,3761,3473,288,5,15,29,13-2000,Financial Specialists
08,Colorado,1512,115983,100176,15807,227,601,927,6403,5614,789,9,29,33,15-1200,Computer Occupations
08,Colorado,152,5392,5049,343,0,0,0,309,285,24,0,0,0,15-2000,Mathematical Science Occupations
08,Colorado,171,7459,6754,705,0,103,158,404,374,30,0,3,2,17-1000,"Architects, Surveyors, and Cartographers"
08,Colorado,172,49766,44054,5712,66,362,262,2799,2513,286,3,17,13,17-2000,Engineers
08,Colorado,173,12945,12061,884,0,55,285,759,711,48,0,3,11,17-3000,"Drafters, Engineering Technicians, and Mapping Technicians"
08,Colorado,191,5774,5067,707,10,74,0,345,303,42,1,4,0,19-1000,Life Scientists
08,Colorado,192,11774,9636,2138,0,119,118,710,579,131,0,6,4,19-2000,Physical Scientists
08,Colorado,193,6605,6114,491,0,20,96,386,361,25,0,2,4,19-3000,Social Scientists and Related Workers
08,Colorado,194,7181,6168,1013,0,32,337,423,380,43,0,2,8,19-4000,"Life, Physical, and Social Science Technicians"
08,Colorado,195,1130,1086,44,0,0,0,65,61,4,0,0,1,19-5000,Occupational Health and Safety Specialists and Technicians
08,Colorado,211,35371,32871,2500,166,189,826,1955,1837,118,6,6,29,21-1000,"Counselors, Social Workers, and Other Community and Social Service Specialists"
08,Colorado,212,9746,8810,936,62,69,237,601,553,48,2,3,7,21-2000,Religious Workers
08,Colorado,231,19598,18946,652,55,26,15,1106,1070,36,2,3,1,23-1000,"Lawyers, Judges, and Related Workers"
08,Colorado,232,9617,9320,297,0,49,102,550,530,20,0,4,8,23-2000,Legal Support Workers
08,Colorado,251,23746,20535,3211,35,268,171,1481,1263,218,3,15,10,25-1000,Postsecondary Teachers
08,Colorado,252,89681,84535,5146,163,711,1179,5525,5237,288,9,37,48,25-2000,"Preschool, Elementary, Middle, Secondary, and Special Education Teachers"
08,Colorado,253,16784,15346,1438,57,148,361,1048,972,76,1,5,12,25-3000,Other Teachers and Instructors
08,Colorado,254,5010,4900,110,0,10,41,336,327,9,0,1,4,25-4000,"Librarians, Curators, and Archivists"
08,Colorado,259,20575,18151,2424,43,115,990,1275,1144,131,6,5,40,25-9000,Other Educational Instruction and Library Occupations
08,Colorado,271,21670,20711,959,52,27,222,1295,1233,62,3,2,8,27-1000,Art and Design Workers
08,Colorado,272,16437,15365,1072,0,45,131,1001,947,54,1,3,5,27-2000,"Entertainers and Performers, Sports and Related Workers"
08,Colorado,273,17421,15729,1692,152,156,447,1030,947,83,4,10,16,27-3000,Media and Communication Workers
08,Colorado,274,6988,6560,428,17,0,15,424,399,25,1,0,1,27-4000,Media and Communication Equipment Workers
08,Colorado,291,109678,101197,8481,67,426,403,6137,5678,459,4,23,21,29-1000,Healthcare Diagnosing or Treating Practitioners
08,Colorado,292,40570,37227,3343,132,120,623,2171,2031,140,6,6,28,29-2000,Health Technologists and Technicians
08,Colorado,299,2282,2111,171,0,0,0,108,101,7,0,0,0,29-9000,Other Healthcare Practitioners and Technical Occupations
08,Colorado,3111,41157,34911,6246,289,94,2210,2220,1924,296,15,10,76,31-1100,"Home Health and Personal Care Aides; and Nursing Assistants, Orderlies, and Psychiatric Aides"
08,Colorado,312,1356,1274,82,0,22,60,85,82,3,0,1,1,31-2000,Occupational Therapy and Physical Therapist Assistants and Aides
08,Colorado,319,28821,25827,2994,150,187,1367,1496,1371,125,4,6,49,31-9000,Other Healthcare Support Occupations
08,Colorado,331,5460,5273,187,0,6,0,312,301,11,0,1,0,33-1000,Supervisors of Protective Service Workers
08,Colorado,332,7437,7361,76,0,0,0,379,372,7,1,0,0,33-2000,Firefighting and Prevention Workers
08,Colorado,333,21615,20607,1008,67,94,414,1187,1148,39,2,2,13,33-3000,Law Enforcement Workers
08,Colorado,339,23766,21958,1808,59,21,659,1405,1335,70,1,1,15,33-9000,Other Protective Service Workers
08,Colorado,351,22973,19506,3467,182,108,1310,977,846,131,7,4,43,35-1000,Supervisors of Food Preparation and Serving Workers
08,Colorado,352,63053,48195,14858,1512,299,9738,3241,2686,555,40,15,330,35-2000,Cooks and Food Preparation Workers
08,Colorado,353,68009,61420,6589,128,160,2595,3514,3219,295,5,8,98,35-3000,Food and Beverage Serving Workers
08,Colorado,359,17579,14639,2940,355,143,1255,1160,1023,137,16,5,52,35-9000,Other Food Preparation and Serving Related Workers
08,Colorado,371,7021,5345,1676,74,0,1341,347,285,62,3,0,46,37-1000,Supervisors of Building and Grounds Cleaning and Maintenance Workers
08,Colorado,372,63015,39649,23366,1944,764,16849,3377,2482,895,74,33,596,37-2000,Building Cleaning and Pest Control Workers
08,Colorado,373,21678,16296,5382,703,37,4151,1227,1054,173,20,1,126,37-3000,Grounds Maintenance Workers
08,Colorado,391,1934,1809,125,0,0,71,102,96,6,0,0,2,39-1000,Supervisors of Personal Care and Service Workers
08,Colorado,392,8213,7493,720,204,43,136,458,434,24,1,2,5,39-2000,Animal Care and Service Workers
08,Colorado,393,5814,5327,487,39,0,19,422,400,22,3,0,1,39-3000,Entertainment Attendants and Related Workers
08,Colorado,394,772,772,0,0,0,0,33,33,0,0,0,0,39-4000,Funeral Service Workers
08,Colorado,395,21663,17229,4434,147,26,742,1029,847,182,4,2,23,39-5000,Personal Appearance Workers
08,Colorado,396,2008,1707,301,0,0,63,98,85,13,0,0,3,39-6000,"Baggage Porters, Bellhops, and Concierges"
08,Colorado,397,1799,1647,152,0,38,0,110,101,9,0,4,0,39-7000,Tour and Travel Guides
08,Colorado,399,34193,30789,3404,131,577,1202,2238,2060,178,6,22,58,39-9000,Other Personal Care and Service Workers
08,Colorado,411,82994,76098,6896,157,233,1968,4253,3942,311,9,11,78,41-1000,Supervisors of Sales Workers
08,Colorado,412,108171,97251,10920,210,496,4393,6388,5860,528,12,18,152,41-2000,Retail Sales Workers
08,Colorado,413,37045,34768,2277,123,73,498,1994,1895,99,5,6,19,41-3000,"Sales Representatives, Services"
08,Colorado,414,24618,23062,1556,0,204,517,1338,1265,73,0,6,22,41-4000,"Sales Representatives, Wholesale and Manufacturing"
08,Colorado,419,31208,29398,1810,80,139,291,1807,1699,108,3,9,9,41-9000,Other Sales and Related Workers
08,Colorado,431,22517,20476,2041,17,206,719,1286,1197,89,1,9,21,43-1000,Supervisors of Office and Administrative Support Workers
08,Colorado,432,1334,1271,63,0,0,0,82,77,5,0,0,1,43-2000,Communications Equipment Operators
08,Colorado,433,42251,39173,3078,99,135,1176,2508,2344,164,4,8,49,43-3000,Financial Clerks
08,Colorado,434,106099,97444,8655,365,517,3198,5827,5418,409,20,20,135,43-4000,Information and Record Clerks
08,Colorado,435,34224,30386,3838,69,51,1401,1830,1667,163,3,3,48,43-5000,"Material Recording, Scheduling, Dispatching, and Distributing Workers"
08,Colorado,436,47767,44172,3595,203,197,1765,2926,2752,174,8,11,63,43-6000,Secretaries and Administrative Assistants
08,Colorado,439,45371,42450,2921,122,142,960,2710,2550,160,5,7,44,43-9000,Other Office and Administrative Support Workers
08,Colorado,451,762,682,80,0,0,50,56,51,5,0,0,4,45-1000,"Supervisors of Farming, Fishing, and Forestry Workers"
08,Colorado,452,13785,10169,3616,141,0,3247,1001,828,173,6,0,155,45-2000,Agricultural Workers
08,Colorado,453,49,49,0,0,0,0,12,12,0,0,0,0,45-3000,Fishing and Hunting Workers
08,Colorado,454,722,598,124,0,0,59,57,50,7,0,0,5,45-4000,"Forest, Conservation, and Logging Workers"
08,Colorado,471,19805,16405,3400,96,158,2803,1001,866,135,5,5,102,47-1000,Supervisors of Construction and Extraction Workers
08,Colorado,472,131224,89744,41480,3999,586,34280,6047,4813,1234,107,17,981,47-2000,Construction Trades Workers
08,Colorado,473,546,381,165,64,0,101,33,26,7,2,0,4,47-3000,"Helpers, Construction Trades"
08,Colorado,474,7240,6533,707,0,33,594,397,373,24,0,1,18,47-4000,Other Construction and Related Workers
08,Colorado,475,6605,5660,945,0,0,909,348,312,36,0,0,32,47-5000,Extraction Workers
08,Colorado,491,4399,4118,281,0,0,37,261,248,13,0,0,2,49-1000,"Supervisors of Installation, Maintenance, and Repair Workers"
08,Colorado,492,7092,6429,663,23,8,412,410,380,30,1,1,13,49-2000,"Electrical and Electronic Equipment Mechanics, Installers, and Repairers"
08,Colorado,493,31564,28858,2706,97,44,1818,1601,1487,114,5,3,61,49-3000,"Vehicle and Mobile Equipment Mechanics, Installers, and Repairers"
08,Colorado,499,32047,28127,3920,226,117,2237,1654,1519,135,10,4,70,49-9000,"Other Installation, Maintenance, and Repair Occupations"
08,Colorado,511,8906,7674,1232,32,22,738,463,413,50,2,1,24,51-1000,Supervisors of Production Workers
08,Colorado,512,12156,8779,3377,253,80,983,664,502,162,5,2,50,51-2000,Assemblers and Fabricators
08,Colorado,513,11699,7624,4075,479,271,1972,590,440,150,13,8,69,51-3000,Food Processing Workers
08,Colorado,514,14451,11712,2739,37,0,1949,783,674,109,3,1,65,51-4000,Metal Workers and Plastic Workers
08,Colorado,5151,2997,2466,531,0,0,306,161,140,21,1,0,9,51-5100,Printing Workers
08,Colorado,516,6257,3742,2515,216,19,1422,354,253,101,4,3,49,51-6000,"Textile, Apparel, and Furnishings Workers"
08,Colorado,517,2238,1797,441,0,0,395,112,103,9,0,0,8,51-7000,Woodworkers
08,Colorado,518,5628,5124,504,63,75,124,333,316,17,1,1,3,51-8000,Plant and System Operators
08,Colorado,519,38071,30272,7799,694,323,3960,1943,1622,321,22,10,160,51-9000,Other Production Occupations
08,Colorado,531,3315,3003,312,14,0,200,173,160,13,1,0,6,53-1000,Supervisors of Transportation and Material Moving Workers
08,Colorado,532,10986,10380,606,31,86,0,582,554,28,1,3,0,53-2000,Air Transportation Workers
08,Colorado,533,71047,60134,10913,492,341,4734,3653,3215,438,17,14,179,53-3000,Motor Vehicle Operators
08,Colorado,534,1958,1936,22,0,0,0,134,129,5,0,0,2,53-4000,Rail Transportation Workers
08,Colorado,535,217,217,0,0,0,0,11,11,0,0,0,0,53-5000,Water Transportation Workers
08,Colorado,536,4086,3692,394,63,0,78,209,193,16,1,0,3,53-6000,Other Transportation Workers
08,Colorado,537,76771,64530,12241,784,208,7524,4218,3746,472,23,14,269,53-7000,Material Moving Workers
09,Connecticut,111,27902,24720,3182,80,434,38,1652,1441,211,4,26,3,11-1000,Top Executives
09,Connecticut,112,14704,13445,1259,0,159,14,880,799,81,1,10,1,11-2000,"Advertising, Marketing, Promotions, Public Relations, and Sales Managers"
09,Connecticut,113,44561,36772,7789,389,889,240,2582,2134,448,8,46,11,11-3000,Operations Specialties Managers
09,Connecticut,119,104995,89908,15087,594,2045,419,5862,5098,764,24,100,15,11-9000,Other Management Occupations
09,Connecticut,131,59442,52279,7163,137,1062,83,3535,3118,417,6,45,8,13-1000,Business Operations Specialists
09,Connecticut,132,49562,41747,7815,117,892,138,2814,2381,433,7,48,8,13-2000,Financial Specialists
09,Connecticut,1512,51434,36680,14754,87,636,64,2871,2132,739,7,36,3,15-1200,Computer Occupations
09,Connecticut,152,4389,3285,1104,0,73,0,272,210,62,0,4,0,15-2000,Mathematical Science Occupations
09,Connecticut,171,3472,3190,282,0,32,0,219,190,29,0,3,0,17-1000,"Architects, Surveyors, and Cartographers"
09,Connecticut,172,29099,23847,5252,27,392,93,1608,1329,279,2,21,6,17-2000,Engineers
09,Connecticut,173,6240,5573,667,0,32,0,391,348,43,0,3,0,17-3000,"Drafters, Engineering Technicians, and Mapping Technicians"
09,Connecticut,191,3290,2295,995,25,66,0,201,143,58,2,3,0,19-1000,Life Scientists
09,Connecticut,192,5793,3654,2139,0,78,15,348,229,119,0,6,1,19-2000,Physical Scientists
09,Connecticut,193,4226,3913,313,0,21,0,268,245,23,0,2,0,19-3000,Social Scientists and Related Workers
09,Connecticut,194,3428,2914,514,47,29,9,246,214,32,1,2,1,19-4000,"Life, Physical, and Social Science Technicians"
09,Connecticut,195,763,635,128,0,0,0,42,38,4,0,0,0,19-5000,Occupational Health and Safety Specialists and Technicians
09,Connecticut,211,30091,26880,3211,65,471,31,1630,1468,162,3,23,3,21-1000,"Counselors, Social Workers, and Other Community and Social Service Specialists"
09,Connecticut,212,3517,2970,547,0,225,0,229,202,27,0,5,0,21-2000,Religious Workers
09,Connecticut,231,14461,13809,652,0,85,0,879,827,52,0,5,0,23-1000,"Lawyers, Judges, and Related Workers"
09,Connecticut,232,6620,5928,692,38,97,19,351,318,33,3,3,1,23-2000,Legal Support Workers
09,Connecticut,251,16975,11875,5100,71,347,23,1099,785,314,4,17,3,25-1000,Postsecondary Teachers
09,Connecticut,252,70516,65368,5148,99,1016,51,4296,3964,332,5,51,3,25-2000,"Preschool, Elementary, Middle, Secondary, and Special Education Teachers"
09,Connecticut,253,11567,10335,1232,0,169,19,776,686,90,0,13,1,25-3000,Other Teachers and Instructors
09,Connecticut,254,4381,3925,456,0,0,0,301,267,34,0,0,0,25-4000,"Librarians, Curators, and Archivists"
09,Connecticut,259,18005,15833,2172,62,210,73,1104,975,129,3,13,4,25-9000,Other Educational Instruction and Library Occupations
09,Connecticut,271,12014,10330,1684,10,380,67,809,715,94,1,14,4,27-1000,Art and Design Workers
09,Connecticut,272,10123,9006,1117,10,224,29,751,685,66,2,9,2,27-2000,"Entertainers and Performers, Sports and Related Workers"
09,Connecticut,273,9884,9004,880,24,216,38,660,606,54,1,10,2,27-3000,Media and Communication Workers
09,Connecticut,274,3641,3190,451,0,0,44,224,206,18,0,0,1,27-4000,Media and Communication Equipment Workers
09,Connecticut,291,75901,63282,12619,211,961,102,4284,3617,667,9,48,5,29-1000,Healthcare Diagnosing or Treating Practitioners
09,Connecticut,292,29581,24389,5192,61,805,76,1508,1268,240,4,35,5,29-2000,Health Technologists and Technicians
09,Connecticut,299,933,887,46,0,0,0,48,45,3,0,0,0,29-9000,Other Healthcare Practitioners and Technical Occupations
09,Connecticut,3111,46450,32543,13907,496,1810,182,2188,1576,612,19,83,9,31-1100,"Home Health and Personal Care Aides; and Nursing Assistants, Orderlies, and Psychiatric Aides"
09,Connecticut,312,1312,1123,189,0,44,0,87,78,9,0,3,0,31-2000,Occupational Therapy and Physical Therapist Assistants and Aides
09,Connecticut,319,16629,14153,2476,123,539,131,856,735,121,4,28,5,31-9000,Other Healthcare Support Occupations
09,Connecticut,331,2999,2677,322,27,48,32,169,160,9,1,1,1,33-1000,Supervisors of Protective Service Workers
09,Connecticut,332,3631,3527,104,0,0,0,189,184,5,0,1,0,33-2000,Firefighting and Prevention Workers
09,Connecticut,333,12820,11743,1077,18,160,0,655,599,56,2,6,0,33-3000,Law Enforcement Workers
09,Connecticut,339,13627,12210,1417,77,190,62,856,792,64,7,10,1,33-9000,Other Protective Service Workers
09,Connecticut,351,12942,9263,3679,350,623,583,601,456,145,11,23,16,35-1000,Supervisors of Food Preparation and Serving Workers
09,Connecticut,352,29704,20303,9401,1415,1836,2691,1582,1254,328,38,59,68,35-2000,Cooks and Food Preparation Workers
09,Connecticut,353,34585,30009,4576,537,1165,523,2021,1773,248,26,51,22,35-3000,Food and Beverage Serving Workers
09,Connecticut,359,10127,7844,2283,364,564,541,671,568,103,17,21,14,35-9000,Other Food Preparation and Serving Related Workers
09,Connecticut,371,5150,3749,1401,222,640,98,263,207,56,10,20,7,37-1000,Supervisors of Building and Grounds Cleaning and Maintenance Workers
09,Connecticut,372,44090,23716,20374,2974,8206,1988,2231,1421,810,104,306,67,37-2000,Building Cleaning and Pest Control Workers
09,Connecticut,373,18179,11680,6499,2131,1883,1779,990,773,217,66,55,54,37-3000,Grounds Maintenance Workers
09,Connecticut,391,1841,1527,314,0,64,0,89,69,20,0,3,0,39-1000,Supervisors of Personal Care and Service Workers
09,Connecticut,392,3569,3328,241,0,112,0,210,199,11,0,3,0,39-2000,Animal Care and Service Workers
09,Connecticut,393,6057,4242,1815,0,394,17,372,295,77,0,18,2,39-3000,Entertainment Attendants and Related Workers
09,Connecticut,394,272,258,14,0,0,0,21,20,1,0,0,0,39-4000,Funeral Service Workers
09,Connecticut,395,13972,10771,3201,142,735,103,692,539,153,6,31,5,39-5000,Personal Appearance Workers
09,Connecticut,396,831,718,113,0,0,0,28,25,3,0,0,0,39-6000,"Baggage Porters, Bellhops, and Concierges"
09,Connecticut,397,846,846,0,0,0,0,64,64,0,0,0,0,39-7000,Tour and Travel Guides
09,Connecticut,399,28115,22771,5344,452,1335,270,1944,1657,287,21,66,17,39-9000,Other Personal Care and Service Workers
09,Connecticut,411,50356,42358,7998,233,1563,341,2635,2297,338,12,53,8,41-1000,Supervisors of Sales Workers
09,Connecticut,412,70307,58985,11322,1024,1688,559,4246,3697,549,33,75,25,41-2000,Retail Sales Workers
09,Connecticut,413,21640,19104,2536,37,243,0,1329,1200,129,2,13,0,41-3000,"Sales Representatives, Services"
09,Connecticut,414,14794,13707,1087,65,167,42,843,779,64,3,9,3,41-4000,"Sales Representatives, Wholesale and Manufacturing"
09,Connecticut,419,13238,12051,1187,42,210,18,796,719,77,2,13,1,41-9000,Other Sales and Related Workers
09,Connecticut,431,12564,11308,1256,23,192,22,713,642,71,2,12,1,43-1000,Supervisors of Office and Administrative Support Workers
09,Connecticut,432,898,797,101,0,0,0,48,41,7,0,0,0,43-2000,Communications Equipment Operators
09,Connecticut,433,25396,22080,3316,88,491,94,1495,1311,184,6,22,3,43-3000,Financial Clerks
09,Connecticut,434,54326,48588,5738,93,1106,260,3108,2775,333,8,59,15,43-4000,Information and Record Clerks
09,Connecticut,435,23569,20252,3317,113,531,61,1243,1076,167,6,26,2,43-5000,"Material Recording, Scheduling, Dispatching, and Distributing Workers"
09,Connecticut,436,35104,32159,2945,78,609,213,2160,1991,169,7,39,4,43-6000,Secretaries and Administrative Assistants
09,Connecticut,439,30118,26267,3851,69,906,174,1812,1622,190,4,37,4,43-9000,Other Office and Administrative Support Workers
09,Connecticut,451,195,160,35,0,0,35,12,11,1,0,0,1,45-1000,"Supervisors of Farming, Fishing, and Forestry Workers"
09,Connecticut,452,1997,1448,549,227,111,155,149,130,19,5,5,4,45-2000,Agricultural Workers
09,Connecticut,453,210,164,46,46,0,0,10,8,2,1,0,0,45-3000,Fishing and Hunting Workers
09,Connecticut,454,264,255,9,9,0,0,23,22,1,1,0,0,45-4000,"Forest, Conservation, and Logging Workers"
09,Connecticut,471,6234,5291,943,58,302,65,361,311,50,2,13,4,47-1000,Supervisors of Construction and Extraction Workers
09,Connecticut,472,68083,44215,23868,4300,8940,2946,3318,2527,791,117,238,99,47-2000,Construction Trades Workers
09,Connecticut,473,267,195,72,54,0,0,23,18,5,2,0,0,47-3000,"Helpers, Construction Trades"
09,Connecticut,474,3481,3178,303,75,58,60,180,162,18,4,4,2,47-4000,Other Construction and Related Workers
09,Connecticut,475,743,692,51,40,0,0,45,43,2,1,0,0,47-5000,Extraction Workers
09,Connecticut,491,1940,1822,118,0,12,0,90,83,7,0,1,0,49-1000,"Supervisors of Installation, Maintenance, and Repair Workers"
09,Connecticut,492,5026,4111,915,0,246,0,256,216,40,0,10,0,49-2000,"Electrical and Electronic Equipment Mechanics, Installers, and Repairers"
09,Connecticut,493,16421,13862,2559,203,633,237,828,729,99,6,23,5,49-3000,"Vehicle and Mobile Equipment Mechanics, Installers, and Repairers"
09,Connecticut,499,20946,18141,2805,321,570,275,1079,968,111,9,21,9,49-9000,"Other Installation, Maintenance, and Repair Occupations"
09,Connecticut,511,7646,6308,1338,10,436,0,405,340,65,1,16,1,51-1000,Supervisors of Production Workers
09,Connecticut,512,10022,6712,3310,88,579,113,552,384,168,6,30,4,51-2000,Assemblers and Fabricators
09,Connecticut,513,5572,3808,1764,133,411,315,293,224,69,4,18,8,51-3000,Food Processing Workers
09,Connecticut,514,20273,15478,4795,158,578,126,988,765,223,6,25,5,51-4000,Metal Workers and Plastic Workers
09,Connecticut,5151,2260,1756,504,0,173,0,137,111,26,0,9,0,51-5100,Printing Workers
09,Connecticut,516,3637,1874,1763,235,220,158,200,119,81,5,12,9,51-6000,"Textile, Apparel, and Furnishings Workers"
09,Connecticut,517,1106,798,308,32,61,24,71,56,15,2,3,1,51-7000,Woodworkers
09,Connecticut,518,1945,1796,149,15,0,0,114,107,7,1,0,0,51-8000,Plant and System Operators
09,Connecticut,519,27179,19780,7399,416,1517,517,1424,1073,351,21,59,18,51-9000,Other Production Occupations
09,Connecticut,531,1915,1452,463,17,38,0,90,73,17,1,2,0,53-1000,Supervisors of Transportation and Material Moving Workers
09,Connecticut,532,1468,1218,250,0,38,0,90,76,14,0,2,0,53-2000,Air Transportation Workers
09,Connecticut,533,38501,30374,8127,623,1831,321,1911,1588,323,15,59,14,53-3000,Motor Vehicle Operators
09,Connecticut,534,1060,1007,53,0,53,0,48,47,1,0,1,0,53-4000,Rail Transportation Workers
09,Connecticut,535,671,632,39,22,8,0,50,45,5,1,1,0,53-5000,Water Transportation Workers
09,Connecticut,536,2909,2197,712,31,111,0,146,119,27,2,5,0,53-6000,Other Transportation Workers
09,Connecticut,537,44823,36120,8703,1097,1797,424,2572,2189,383,34,77,20,53-7000,Material Moving Workers
10,Delaware,111,5278,4730,548,209,16,0,288,264,24,2,2,0,11-1000,Top Executives
10,Delaware,112,2575,2518,57,0,0,57,148,146,2,0,1,1,11-2000,"Advertising, Marketing, Promotions, Public Relations, and Sales Managers"
10,Delaware,113,11348,9993,1355,18,98,46,638,568,70,1,7,3,11-3000,Operations Specialties Managers
10,Delaware,119,25364,22923,2441,112,179,200,1378,1250,128,4,9,13,11-9000,Other Management Occupations
10,Delaware,131,13775,11788,1987,118,152,118,744,663,81,2,3,2,13-1000,Business Operations Specialists
10,Delaware,132,9008,7978,1030,20,33,34,507,452,55,1,2,2,13-2000,Financial Specialists
10,Delaware,1512,13410,9002,4408,0,98,186,669,478,191,0,5,6,15-1200,Computer Occupations
10,Delaware,152,1080,900,180,0,0,0,54,43,11,0,0,0,15-2000,Mathematical Science Occupations
10,Delaware,171,424,372,52,0,0,0,26,24,2,0,0,0,17-1000,"Architects, Surveyors, and Cartographers"
10,Delaware,172,4773,3692,1081,0,0,67,267,227,40,0,0,1,17-2000,Engineers
10,Delaware,173,1645,1569,76,0,22,0,87,83,4,0,1,0,17-3000,"Drafters, Engineering Technicians, and Mapping Technicians"
10,Delaware,191,798,638,160,0,17,0,49,40,9,0,1,0,19-1000,Life Scientists
10,Delaware,192,2385,1427,958,0,30,12,128,87,41,0,1,1,19-2000,Physical Scientists
10,Delaware,193,896,864,32,0,0,0,48,46,2,0,1,0,19-3000,Social Scientists and Related Workers
10,Delaware,194,1800,1593,207,0,0,0,116,103,13,0,0,0,19-4000,"Life, Physical, and Social Science Technicians"
10,Delaware,195,267,267,0,0,0,0,17,17,0,0,0,0,19-5000,Occupational Health and Safety Specialists and Technicians
10,Delaware,211,7317,6842,475,14,0,21,382,360,22,1,0,1,21-1000,"Counselors, Social Workers, and Other Community and Social Service Specialists"
10,Delaware,212,1288,1231,57,0,0,0,68,64,4,0,0,0,21-2000,Religious Workers
10,Delaware,231,3225,3100,125,0,0,0,194,187,7,0,0,0,23-1000,"Lawyers, Judges, and Related Workers"
10,Delaware,232,2122,2083,39,0,0,0,118,116,2,0,0,0,23-2000,Legal Support Workers
10,Delaware,251,4317,3074,1243,14,21,0,259,188,71,1,1,0,25-1000,Postsecondary Teachers
10,Delaware,252,15196,14421,775,202,35,23,890,848,42,6,3,1,25-2000,"Preschool, Elementary, Middle, Secondary, and Special Education Teachers"
10,Delaware,253,1988,1926,62,0,4,6,117,111,6,0,1,1,25-3000,Other Teachers and Instructors
10,Delaware,254,549,545,4,0,0,0,34,32,2,0,0,0,25-4000,"Librarians, Curators, and Archivists"
10,Delaware,259,4067,3738,329,44,0,12,239,220,19,3,2,1,25-9000,Other Educational Instruction and Library Occupations
10,Delaware,271,2174,1963,211,0,0,54,126,116,10,0,0,3,27-1000,Art and Design Workers
10,Delaware,272,1905,1593,312,0,27,156,104,95,9,0,1,2,27-2000,"Entertainers and Performers, Sports and Related Workers"
10,Delaware,273,1593,1468,125,6,13,34,100,91,9,1,1,1,27-3000,Media and Communication Workers
10,Delaware,274,545,516,29,0,10,0,33,30,3,0,1,0,27-4000,Media and Communication Equipment Workers
10,Delaware,291,19712,17113,2599,0,78,26,992,876,116,0,5,2,29-1000,Healthcare Diagnosing or Treating Practitioners
10,Delaware,292,9302,8302,1000,9,103,53,435,398,37,1,2,1,29-2000,Health Technologists and Technicians
10,Delaware,299,159,104,55,0,0,0,11,10,1,0,0,0,29-9000,Other Healthcare Practitioners and Technical Occupations
10,Delaware,3111,8789,7107,1682,18,33,56,388,322,66,3,2,5,31-1100,"Home Health and Personal Care Aides; and Nursing Assistants, Orderlies, and Psychiatric Aides"
10,Delaware,312,600,549,51,0,0,0,31,27,4,0,0,0,31-2000,Occupational Therapy and Physical Therapist Assistants and Aides
10,Delaware,319,3536,3116,420,0,53,82,195,178,17,0,1,3,31-9000,Other Healthcare Support Occupations
10,Delaware,331,648,644,4,0,0,0,42,41,1,0,0,0,33-1000,Supervisors of Protective Service Workers
10,Delaware,332,532,532,0,0,0,0,30,30,0,0,0,0,33-2000,Firefighting and Prevention Workers
10,Delaware,333,4041,4016,25,0,0,0,210,208,2,0,0,0,33-3000,Law Enforcement Workers
10,Delaware,339,4100,3628,472,0,39,161,245,227,18,0,2,4,33-9000,Other Protective Service Workers
10,Delaware,351,2348,2087,261,0,5,51,119,105,14,0,1,3,35-1000,Supervisors of Food Preparation and Serving Workers
10,Delaware,352,8200,6847,1353,75,46,589,436,380,56,7,1,21,35-2000,Cooks and Food Preparation Workers
10,Delaware,353,11015,9766,1249,45,57,383,666,608,58,2,6,14,35-3000,Food and Beverage Serving Workers
10,Delaware,359,2503,2208,295,65,0,53,191,174,17,5,1,6,35-9000,Other Food Preparation and Serving Related Workers
10,Delaware,371,1407,1167,240,68,27,145,65,56,9,3,1,5,37-1000,Supervisors of Building and Grounds Cleaning and Maintenance Workers
10,Delaware,372,10832,8458,2374,73,197,1458,540,441,99,7,6,48,37-2000,Building Cleaning and Pest Control Workers
10,Delaware,373,4359,2847,1512,342,42,1020,232,179,53,15,1,33,37-3000,Grounds Maintenance Workers
10,Delaware,391,390,324,66,0,14,36,19,16,3,0,1,1,39-1000,Supervisors of Personal Care and Service Workers
10,Delaware,392,1222,1118,104,0,0,48,59,54,5,0,0,2,39-2000,Animal Care and Service Workers
10,Delaware,393,711,652,59,0,10,0,53,49,4,0,1,0,39-3000,Entertainment Attendants and Related Workers
10,Delaware,394,126,126,0,0,0,0,6,6,0,0,0,0,39-4000,Funeral Service Workers
10,Delaware,395,3625,3160,465,18,0,0,171,147,24,1,0,0,39-5000,Personal Appearance Workers
10,Delaware,396,157,118,39,0,0,0,9,8,1,0,0,0,39-6000,"Baggage Porters, Bellhops, and Concierges"
10,Delaware,397,211,211,0,0,0,0,13,13,0,0,0,0,39-7000,Tour and Travel Guides
10,Delaware,399,5065,4786,279,13,60,17,359,332,27,3,4,3,39-9000,Other Personal Care and Service Workers
10,Delaware,411,12223,10669,1554,198,72,173,590,530,60,5,2,5,41-1000,Supervisors of Sales Workers
10,Delaware,412,18636,16709,1927,40,104,216,1137,1056,81,3,7,9,41-2000,Retail Sales Workers
10,Delaware,413,3883,3743,140,18,8,12,190,182,8,1,1,1,41-3000,"Sales Representatives, Services"
10,Delaware,414,2862,2507,355,77,45,120,142,130,12,1,3,3,41-4000,"Sales Representatives, Wholesale and Manufacturing"
10,Delaware,419,2734,2437,297,0,0,0,196,174,22,1,1,0,41-9000,Other Sales and Related Workers
10,Delaware,431,3249,3142,107,0,0,12,192,185,7,0,0,1,43-1000,Supervisors of Office and Administrative Support Workers
10,Delaware,432,27,27,0,0,0,0,3,3,0,0,0,0,43-2000,Communications Equipment Operators
10,Delaware,433,8134,7298,836,39,0,83,442,411,31,1,0,3,43-3000,Financial Clerks
10,Delaware,434,15102,13757,1345,110,96,323,797,749,48,5,5,9,43-4000,Information and Record Clerks
10,Delaware,435,5629,5018,611,0,23,10,301,278,23,0,1,1,43-5000,"Material Recording, Scheduling, Dispatching, and Distributing Workers"
10,Delaware,436,8693,8420,273,31,20,38,546,522,24,4,2,3,43-6000,Secretaries and Administrative Assistants
10,Delaware,439,8871,8322,549,0,98,21,484,459,25,0,4,1,43-9000,Other Office and Administrative Support Workers
10,Delaware,451,16,16,0,0,0,0,1,1,0,0,0,0,45-1000,"Supervisors of Farming, Fishing, and Forestry Workers"
10,Delaware,452,2057,916,1141,452,17,585,93,55,38,9,1,25,45-2000,Agricultural Workers
10,Delaware,453,97,97,0,0,0,0,8,8,0,0,0,0,45-3000,Fishing and Hunting Workers
10,Delaware,454,73,73,0,0,0,0,2,2,0,0,0,0,45-4000,"Forest, Conservation, and Logging Workers"
10,Delaware,471,2853,2558,295,117,22,120,123,113,10,2,1,4,47-1000,Supervisors of Construction and Extraction Workers
10,Delaware,472,18296,14969,3327,709,249,1821,863,750,113,26,11,53,47-2000,Construction Trades Workers
10,Delaware,473,112,85,27,27,0,0,8,7,1,1,0,0,47-3000,"Helpers, Construction Trades"
10,Delaware,474,689,594,95,0,0,57,42,38,4,1,0,2,47-4000,Other Construction and Related Workers
10,Delaware,475,66,45,21,0,0,21,5,4,1,0,0,1,47-5000,Extraction Workers
10,Delaware,491,717,687,30,0,0,0,40,38,2,0,0,0,49-1000,"Supervisors of Installation, Maintenance, and Repair Workers"
10,Delaware,492,1204,1126,78,0,0,0,60,57,3,0,0,0,49-2000,"Electrical and Electronic Equipment Mechanics, Installers, and Repairers"
10,Delaware,493,5475,5036,439,101,35,232,281,266,15,2,1,5,49-3000,"Vehicle and Mobile Equipment Mechanics, Installers, and Repairers"
10,Delaware,499,6869,6293,576,129,12,260,342,315,27,5,1,12,49-9000,"Other Installation, Maintenance, and Repair Occupations"
10,Delaware,511,2471,2090,381,62,35,183,105,95,10,2,1,3,51-1000,Supervisors of Production Workers
10,Delaware,512,1207,974,233,99,0,65,67,58,9,2,0,3,51-2000,Assemblers and Fabricators
10,Delaware,513,1924,1257,667,162,0,86,100,78,22,8,0,4,51-3000,Food Processing Workers
10,Delaware,514,2509,2300,209,0,81,56,124,117,7,0,2,2,51-4000,Metal Workers and Plastic Workers
10,Delaware,5151,293,287,6,0,0,0,16,14,2,1,0,0,51-5100,Printing Workers
10,Delaware,516,770,443,327,0,0,89,40,28,12,0,0,5,51-6000,"Textile, Apparel, and Furnishings Workers"
10,Delaware,517,62,62,0,0,0,0,9,9,0,0,0,0,51-7000,Woodworkers
10,Delaware,518,708,671,37,0,0,0,41,39,2,0,0,0,51-8000,Plant and System Operators
10,Delaware,519,8496,6588,1908,455,89,694,387,322,65,18,5,19,51-9000,Other Production Occupations
10,Delaware,531,714,660,54,0,28,0,36,34,2,0,1,0,53-1000,Supervisors of Transportation and Material Moving Workers
10,Delaware,532,894,881,13,0,0,0,44,43,1,0,0,0,53-2000,Air Transportation Workers
10,Delaware,533,11894,10670,1224,30,219,228,595,548,47,1,7,11,53-3000,Motor Vehicle Operators
10,Delaware,534,135,135,0,0,0,0,8,8,0,0,0,0,53-4000,Rail Transportation Workers
10,Delaware,535,447,447,0,0,0,0,23,23,0,0,0,0,53-5000,Water Transportation Workers
10,Delaware,536,752,716,36,18,0,18,38,36,2,1,0,1,53-6000,Other Transportation Workers
10,Delaware,537,14782,12903,1879,202,107,696,803,716,87,12,12,21,53-7000,Material Moving Workers
11,District of Columbia,111,8016,7183,833,81,22,0,468,421,47,3,2,0,11-1000,Top Executives
11,District of Columbia,112,4911,4438,473,65,87,0,292,260,32,2,4,1,11-2000,"Advertising, Marketing, Promotions, Public Relations, and Sales Managers"
11,District of Columbia,113,9308,7715,1593,43,301,56,525,445,80,3,13,3,11-3000,Operations Specialties Managers
11,District of Columbia,119,34911,29983,4928,434,663,135,1969,1724,245,22,29,6,11-9000,Other Management Occupations
11,District of Columbia,131,33174,29079,4095,133,332,104,1891,1678,213,7,19,4,13-1000,Business Operations Specialists
11,District of Columbia,132,9382,7862,1520,8,144,0,497,424,73,1,7,0,13-2000,Financial Specialists
11,District of Columbia,1512,17236,14707,2529,239,295,94,946,806,140,13,14,5,15-1200,Computer Occupations
11,District of Columbia,152,6447,5536,911,58,95,0,354,310,44,2,5,0,15-2000,Mathematical Science Occupations
11,District of Columbia,171,1372,1161,211,0,7,16,85,69,16,0,2,1,17-1000,"Architects, Surveyors, and Cartographers"
11,District of Columbia,172,3717,2920,797,0,42,0,194,166,28,0,1,0,17-2000,Engineers
11,District of Columbia,173,222,196,26,0,8,0,21,16,5,0,2,0,17-3000,"Drafters, Engineering Technicians, and Mapping Technicians"
11,District of Columbia,191,1674,1078,596,39,25,0,87,62,25,1,1,0,19-1000,Life Scientists
11,District of Columbia,192,3521,2353,1168,0,133,163,181,138,43,0,7,1,19-2000,Physical Scientists
11,District of Columbia,193,5984,4148,1836,134,329,51,327,233,94,3,15,3,19-3000,Social Scientists and Related Workers
11,District of Columbia,194,1910,1492,418,28,142,0,161,135,26,2,8,0,19-4000,"Life, Physical, and Social Science Technicians"
11,District of Columbia,195,176,148,28,0,0,0,8,7,1,0,0,0,19-5000,Occupational Health and Safety Specialists and Technicians
11,District of Columbia,211,7160,6263,897,22,38,21,415,361,54,1,3,3,21-1000,"Counselors, Social Workers, and Other Community and Social Service Specialists"
11,District of Columbia,212,648,615,33,0,0,2,49,45,4,0,0,1,21-2000,Religious Workers
11,District of Columbia,231,19717,17264,2453,93,353,323,1158,1041,117,4,14,4,23-1000,"Lawyers, Judges, and Related Workers"
11,District of Columbia,232,4573,3984,589,167,123,15,315,277,38,5,10,1,23-2000,Legal Support Workers
11,District of Columbia,251,5160,4046,1114,0,85,61,341,264,77,1,6,2,25-1000,Postsecondary Teachers
11,District of Columbia,252,9191,7771,1420,52,331,34,506,439,67,3,11,3,25-2000,"Preschool, Elementary, Middle, Secondary, and Special Education Teachers"
11,District of Columbia,253,2627,2238,389,28,81,20,204,176,28,3,4,1,25-3000,Other Teachers and Instructors
11,District of Columbia,254,1885,1704,181,0,23,0,116,104,12,0,1,0,25-4000,"Librarians, Curators, and Archivists"
11,District of Columbia,259,3253,2920,333,40,57,18,210,182,28,2,3,1,25-9000,Other Educational Instruction and Library Occupations
11,District of Columbia,271,3612,3056,556,0,127,0,204,174,30,0,4,0,27-1000,Art and Design Workers
11,District of Columbia,272,2809,2493,316,0,0,10,210,186,24,2,1,1,27-2000,"Entertainers and Performers, Sports and Related Workers"
11,District of Columbia,273,13580,11487,2093,90,229,105,812,708,104,5,11,5,27-3000,Media and Communication Workers
11,District of Columbia,274,1104,828,276,0,37,0,61,50,11,0,2,0,27-4000,Media and Communication Equipment Workers
11,District of Columbia,291,9224,7723,1501,0,96,32,494,416,78,0,6,2,29-1000,Healthcare Diagnosing or Treating Practitioners
11,District of Columbia,292,2119,1728,391,60,26,0,133,108,25,3,2,0,29-2000,Health Technologists and Technicians
11,District of Columbia,299,407,288,119,14,0,0,24,19,5,1,0,0,29-9000,Other Healthcare Practitioners and Technical Occupations
11,District of Columbia,3111,4150,2724,1426,133,16,0,197,141,56,5,2,0,31-1100,"Home Health and Personal Care Aides; and Nursing Assistants, Orderlies, and Psychiatric Aides"
11,District of Columbia,312,133,118,15,0,0,0,7,6,1,0,0,0,31-2000,Occupational Therapy and Physical Therapist Assistants and Aides
11,District of Columbia,319,1708,1452,256,50,0,57,91,76,15,2,0,2,31-9000,Other Healthcare Support Occupations
11,District of Columbia,331,498,431,67,0,0,0,33,31,2,0,0,0,33-1000,Supervisors of Protective Service Workers
11,District of Columbia,332,169,148,21,0,21,0,18,17,1,0,1,0,33-2000,Firefighting and Prevention Workers
11,District of Columbia,333,2063,1978,85,0,0,0,118,112,6,0,0,0,33-3000,Law Enforcement Workers
11,District of Columbia,339,6246,5766,480,0,10,0,352,327,25,0,1,0,33-9000,Other Protective Service Workers
11,District of Columbia,351,1828,1432,396,175,32,55,97,79,18,6,2,2,35-1000,Supervisors of Food Preparation and Serving Workers
11,District of Columbia,352,6770,3989,2781,1667,22,354,332,226,106,53,3,15,35-2000,Cooks and Food Preparation Workers
11,District of Columbia,353,5852,4624,1228,304,74,104,359,299,60,12,6,5,35-3000,Food and Beverage Serving Workers
11,District of Columbia,359,2210,1363,847,673,16,26,142,103,39,23,3,1,35-9000,Other Food Preparation and Serving Related Workers
11,District of Columbia,371,506,401,105,49,0,0,30,26,4,2,0,0,37-1000,Supervisors of Building and Grounds Cleaning and Maintenance Workers
11,District of Columbia,372,9656,4679,4977,2895,158,182,449,285,164,76,6,12,37-2000,Building Cleaning and Pest Control Workers
11,District of Columbia,373,667,483,184,165,0,0,59,47,12,7,0,0,37-3000,Grounds Maintenance Workers
11,District of Columbia,391,137,61,76,0,7,0,9,4,5,0,1,0,39-1000,Supervisors of Personal Care and Service Workers
11,District of Columbia,392,531,471,60,0,0,0,33,28,5,0,1,0,39-2000,Animal Care and Service Workers
11,District of Columbia,393,477,402,75,0,0,0,45,40,5,0,0,0,39-3000,Entertainment Attendants and Related Workers
11,District of Columbia,394,41,41,0,0,0,0,2,2,0,0,0,0,39-4000,Funeral Service Workers
11,District of Columbia,395,1472,1242,230,95,7,0,68,52,16,4,2,0,39-5000,Personal Appearance Workers
11,District of Columbia,396,499,383,116,31,0,0,34,29,5,1,0,0,39-6000,"Baggage Porters, Bellhops, and Concierges"
11,District of Columbia,397,313,292,21,0,0,0,20,18,2,0,0,0,39-7000,Tour and Travel Guides
11,District of Columbia,399,5905,3790,2115,277,398,146,418,329,89,11,17,8,39-9000,Other Personal Care and Service Workers
11,District of Columbia,411,4605,3974,631,64,10,16,255,220,35,3,1,1,41-1000,Supervisors of Sales Workers
11,District of Columbia,412,8053,6860,1193,371,0,0,664,591,73,14,3,1,41-2000,Retail Sales Workers
11,District of Columbia,413,3724,3234,490,8,148,16,202,172,30,1,6,1,41-3000,"Sales Representatives, Services"
11,District of Columbia,414,984,696,288,0,0,0,60,49,11,0,0,0,41-4000,"Sales Representatives, Wholesale and Manufacturing"
11,District of Columbia,419,2995,2792,203,32,8,0,186,170,16,1,2,0,41-9000,Other Sales and Related Workers
11,District of Columbia,431,2902,2707,195,0,9,33,172,157,15,0,1,2,43-1000,Supervisors of Office and Administrative Support Workers
11,District of Columbia,432,265,265,0,0,0,0,13,13,0,0,0,0,43-2000,Communications Equipment Operators
11,District of Columbia,433,2928,2456,472,71,63,0,158,132,26,3,4,0,43-3000,Financial Clerks
11,District of Columbia,434,10451,8820,1631,424,110,77,645,567,78,16,5,2,43-4000,Information and Record Clerks
11,District of Columbia,435,2564,2240,324,51,9,16,131,112,19,3,1,1,43-5000,"Material Recording, Scheduling, Dispatching, and Distributing Workers"
11,District of Columbia,436,5709,5318,391,15,78,12,382,347,35,2,6,1,43-6000,Secretaries and Administrative Assistants
11,District of Columbia,439,6787,6147,640,0,142,0,461,422,39,0,7,1,43-9000,Other Office and Administrative Support Workers
11,District of Columbia,451,16,16,0,0,0,0,1,1,0,0,0,0,45-1000,"Supervisors of Farming, Fishing, and Forestry Workers"
11,District of Columbia,452,109,83,26,0,0,0,8,7,1,0,0,0,45-2000,Agricultural Workers
11,District of Columbia,453,25,25,0,0,0,0,1,1,0,0,0,0,45-3000,Fishing and Hunting Workers
11,District of Columbia,454,20,20,0,0,0,0,1,1,0,0,0,0,45-4000,"Forest, Conservation, and Logging Workers"
11,District of Columbia,471,288,182,106,106,0,0,16,12,4,3,0,0,47-1000,Supervisors of Construction and Extraction Workers
11,District of Columbia,472,6093,3376,2717,2003,19,450,260,191,69,45,3,7,47-2000,Construction Trades Workers
11,District of Columbia,473,72,72,0,0,0,0,2,2,0,0,0,0,47-3000,"Helpers, Construction Trades"
11,District of Columbia,474,305,276,29,0,0,0,19,17,2,0,0,0,47-4000,Other Construction and Related Workers
11,District of Columbia,491,144,100,44,23,0,0,9,6,3,1,0,0,49-1000,"Supervisors of Installation, Maintenance, and Repair Workers"
11,District of Columbia,492,541,471,70,0,26,0,27,23,4,0,1,0,49-2000,"Electrical and Electronic Equipment Mechanics, Installers, and Repairers"
11,District of Columbia,493,574,393,181,52,0,0,38,34,4,1,0,0,49-3000,"Vehicle and Mobile Equipment Mechanics, Installers, and Repairers"
11,District of Columbia,499,1285,1124,161,0,39,0,44,39,5,0,1,0,49-9000,"Other Installation, Maintenance, and Repair Occupations"
11,District of Columbia,511,144,104,40,0,0,0,6,5,1,0,0,0,51-1000,Supervisors of Production Workers
11,District of Columbia,512,50,50,0,0,0,0,7,6,1,0,0,0,51-2000,Assemblers and Fabricators
11,District of Columbia,513,428,326,102,24,0,5,24,19,5,1,0,1,51-3000,Food Processing Workers
11,District of Columbia,514,164,128,36,36,0,0,11,8,3,2,0,0,51-4000,Metal Workers and Plastic Workers
11,District of Columbia,5151,247,230,17,0,0,0,11,10,1,0,0,0,51-5100,Printing Workers
11,District of Columbia,516,244,85,159,144,0,0,16,8,8,5,0,0,51-6000,"Textile, Apparel, and Furnishings Workers"
11,District of Columbia,517,81,27,54,54,0,0,6,5,1,1,0,0,51-7000,Woodworkers
11,District of Columbia,518,581,358,223,214,0,0,19,16,3,2,0,0,51-8000,Plant and System Operators
11,District of Columbia,519,813,625,188,0,31,0,58,45,13,1,2,0,51-9000,Other Production Occupations
11,District of Columbia,531,139,120,19,0,0,0,11,9,2,0,0,0,53-1000,Supervisors of Transportation and Material Moving Workers
11,District of Columbia,532,358,331,27,0,0,0,19,17,2,0,0,0,53-2000,Air Transportation Workers
11,District of Columbia,533,5112,3983,1129,238,0,14,270,215,55,9,0,1,53-3000,Motor Vehicle Operators
11,District of Columbia,534,240,240,0,0,0,0,9,9,0,0,0,0,53-4000,Rail Transportation Workers
11,District of Columbia,535,36,36,0,0,0,0,2,2,0,0,0,0,53-5000,Water Transportation Workers
11,District of Columbia,536,671,475,196,0,0,0,39,28,11,1,0,0,53-6000,Other Transportation Workers
11,District of Columbia,537,4409,4211,198,31,0,0,261,247,14,3,0,0,53-7000,Material Moving Workers
12,Florida,111,137612,105810,31802,1516,10476,833,8196,6409,1787,79,568,48,11-1000,Top Executives
12,Florida,112,67608,53555,14053,697,5387,568,3925,3136,789,36,302,31,11-2000,"Advertising, Marketing, Promotions, Public Relations, and Sales Managers"
12,Florida,113,164417,125057,39360,2288,11379,1433,9537,7418,2119,126,616,65,11-3000,Operations Specialties Managers
12,Florida,119,510367,392310,118057,8841,31397,6160,28388,22552,5836,374,1511,253,11-9000,Other Management Occupations
12,Florida,131,258568,208944,49624,3596,14016,1316,14982,12305,2677,177,735,72,13-1000,Business Operations Specialists
12,Florida,132,177358,136986,40372,2098,11980,887,10309,8131,2178,128,610,45,13-2000,Financial Specialists
12,Florida,1512,212569,156059,56510,1821,11474,834,11963,9052,2911,99,529,43,15-1200,Computer Occupations
12,Florida,152,10944,8666,2278,124,447,0,668,542,126,8,24,0,15-2000,Mathematical Science Occupations
12,Florida,171,11431,7944,3487,36,1696,152,659,471,188,4,79,5,17-1000,"Architects, Surveyors, and Cartographers"
12,Florida,172,79874,60694,19180,691,4605,251,4510,3545,965,27,209,13,17-2000,Engineers
12,Florida,173,33563,26135,7428,552,1768,336,1926,1542,384,24,93,12,17-3000,"Drafters, Engineering Technicians, and Mapping Technicians"
12,Florida,191,9436,6668,2768,96,646,28,599,451,148,5,27,1,19-1000,Life Scientists
12,Florida,192,13391,9389,4002,27,525,67,820,605,215,3,29,3,19-2000,Physical Scientists
12,Florida,193,11502,9064,2438,97,665,109,707,565,142,5,38,8,19-3000,Social Scientists and Related Workers
12,Florida,194,14651,11621,3030,154,473,222,858,700,158,7,27,11,19-4000,"Life, Physical, and Social Science Technicians"
12,Florida,195,2882,2306,576,0,85,37,168,140,28,0,8,2,19-5000,Occupational Health and Safety Specialists and Technicians
12,Florida,211,97108,77689,19419,1130,4009,659,5400,4440,960,57,211,27,21-1000,"Counselors, Social Workers, and Other Community and Social Service Specialists"
12,Florida,212,27147,22122,5025,476,1201,246,1611,1329,282,20,61,13,21-2000,Religious Workers
12,Florida,231,58961,51954,7007,357,1908,36,3643,3235,408,19,106,2,23-1000,"Lawyers, Judges, and Related Workers"
12,Florida,232,46184,37553,8631,691,2140,343,2562,2129,433,35,113,11,23-2000,Legal Support Workers
12,Florida,251,59190,41875,17315,467,2592,225,3625,2646,979,27,138,17,25-1000,Postsecondary Teachers
12,Florida,252,276334,234991,41343,2763,9258,1154,16649,14343,2306,141,532,63,25-2000,"Preschool, Elementary, Middle, Secondary, and Special Education Teachers"
12,Florida,253,43709,36020,7689,580,1996,140,2784,2328,456,26,110,15,25-3000,Other Teachers and Instructors
12,Florida,254,9287,7975,1312,64,118,99,613,538,75,3,8,3,25-4000,"Librarians, Curators, and Archivists"
12,Florida,259,55382,42987,12395,667,3414,578,3302,2583,719,46,182,34,25-9000,Other Educational Instruction and Library Occupations
12,Florida,271,59139,43619,15520,1024,6433,642,3471,2650,821,45,334,28,27-1000,Art and Design Workers
12,Florida,272,48696,39215,9481,295,2844,253,2999,2478,521,18,148,18,27-2000,"Entertainers and Performers, Sports and Related Workers"
12,Florida,273,39229,31561,7668,561,2205,268,2421,1967,454,22,135,18,27-3000,Media and Communication Workers
12,Florida,274,22554,17973,4581,310,1685,302,1288,1036,252,10,86,16,27-4000,Media and Communication Equipment Workers
12,Florida,291,371652,271924,99728,4039,12304,1469,20639,15666,4973,195,652,49,29-1000,Healthcare Diagnosing or Treating Practitioners
12,Florida,292,183648,143165,40483,1908,4782,847,9351,7479,1872,90,247,35,29-2000,Health Technologists and Technicians
12,Florida,299,4542,3886,656,81,90,50,258,218,40,1,6,2,29-9000,Other Healthcare Practitioners and Technical Occupations
12,Florida,3111,159585,89943,69642,2688,5789,1186,7457,4640,2817,123,286,58,31-1100,"Home Health and Personal Care Aides; and Nursing Assistants, Orderlies, and Psychiatric Aides"
12,Florida,312,8958,6934,2024,48,211,10,494,395,99,3,15,1,31-2000,Occupational Therapy and Physical Therapist Assistants and Aides
12,Florida,319,97946,71300,26646,1795,5492,624,4921,3704,1217,84,266,33,31-9000,Other Healthcare Support Occupations
12,Florida,331,18578,16159,2419,233,261,12,1150,1032,118,5,13,1,33-1000,Supervisors of Protective Service Workers
12,Florida,332,23820,22225,1595,284,205,79,1360,1267,93,14,12,4,33-2000,Firefighting and Prevention Workers
12,Florida,333,82220,73729,8491,388,1453,166,4481,4063,418,24,62,10,33-3000,Law Enforcement Workers
12,Florida,339,95509,72338,23171,1644,3212,339,4799,3822,977,64,151,15,33-9000,Other Protective Service Workers
12,Florida,351,79907,55761,24146,2417,4228,1552,3641,2641,1000,78,174,57,35-1000,Supervisors of Food Preparation and Serving Workers
12,Florida,352,197879,137346,60533,7577,7321,8670,9715,7263,2452,274,362,305,35-2000,Cooks and Food Preparation Workers
12,Florida,353,275427,217679,57748,5957,13522,4039,13663,11191,2472,233,586,141,35-3000,Food and Beverage Serving Workers
12,Florida,359,65912,48454,17458,2293,2492,1438,3856,3100,756,89,137,58,35-9000,Other Food Preparation and Serving Related Workers
12,Florida,371,35685,23916,11769,2197,3112,1085,1680,1174,506,86,134,39,37-1000,Supervisors of Building and Grounds Cleaning and Maintenance Workers
12,Florida,372,285863,136699,149164,27710,34432,14855,13951,7708,6243,1099,1500,560,37-2000,Building Cleaning and Pest Control Workers
12,Florida,373,111051,67086,43965,15814,2655,13990,5159,3707,1452,455,104,436,37-3000,Grounds Maintenance Workers
12,Florida,391,7531,5583,1948,24,652,34,360,269,91,1,27,2,39-1000,Supervisors of Personal Care and Service Workers
12,Florida,392,23529,20263,3266,397,1007,500,1366,1202,164,17,48,17,39-2000,Animal Care and Service Workers
12,Florida,393,31164,26043,5121,238,1030,237,1646,1412,234,13,46,12,39-3000,Entertainment Attendants and Related Workers
12,Florida,394,2004,1881,123,0,9,0,123,113,10,0,1,0,39-4000,Funeral Service Workers
12,Florida,395,96014,52903,43111,1730,5423,873,4545,2646,1899,78,251,44,39-5000,Personal Appearance Workers
12,Florida,396,8392,5495,2897,297,327,107,381,263,118,10,18,5,39-6000,"Baggage Porters, Bellhops, and Concierges"
12,Florida,397,3558,2794,764,102,342,0,237,195,42,5,14,0,39-7000,Tour and Travel Guides
12,Florida,399,92644,70248,22396,2799,6866,1134,5703,4509,1194,122,347,54,39-9000,Other Personal Care and Service Workers
12,Florida,411,285369,216581,68788,5806,17486,2762,14964,11701,3263,264,859,113,41-1000,Supervisors of Sales Workers
12,Florida,412,465763,355620,110143,9137,23691,4874,25556,20392,5164,407,1131,207,41-2000,Retail Sales Workers
12,Florida,413,123139,97300,25839,1431,7831,787,6536,5287,1249,71,356,40,41-3000,"Sales Representatives, Services"
12,Florida,414,75812,58878,16934,1788,5671,500,4262,3411,851,79,268,27,41-4000,"Sales Representatives, Wholesale and Manufacturing"
12,Florida,419,120298,90928,29370,1566,10566,799,7122,5536,1586,76,547,46,41-9000,Other Sales and Related Workers
12,Florida,431,80777,63818,16959,1401,4793,693,4541,3684,857,64,216,32,43-1000,Supervisors of Office and Administrative Support Workers
12,Florida,432,6002,4674,1328,118,326,57,315,266,49,4,11,1,43-2000,Communications Equipment Operators
12,Florida,433,144707,114410,30297,2496,7901,689,8284,6673,1611,132,411,41,43-3000,Financial Clerks
12,Florida,434,395393,314632,80761,6906,19409,2576,20832,16981,3851,314,934,125,43-4000,Information and Record Clerks
12,Florida,435,111985,87169,24816,2154,5169,924,5961,4817,1144,103,241,45,43-5000,"Material Recording, Scheduling, Dispatching, and Distributing Workers"
12,Florida,436,166640,132321,34319,3214,9163,1434,10571,8603,1968,162,538,66,43-6000,Secretaries and Administrative Assistants
12,Florida,439,182842,147655,35187,2896,8298,1091,10460,8577,1883,150,441,55,43-9000,Other Office and Administrative Support Workers
12,Florida,451,3098,1969,1129,179,70,650,168,112,56,9,4,34,45-1000,"Supervisors of Farming, Fishing, and Forestry Workers"
12,Florida,452,44184,15123,29061,5752,673,18792,2158,838,1320,212,39,855,45-2000,Agricultural Workers
12,Florida,453,4777,4214,563,152,0,6,303,273,30,3,0,1,45-3000,Fishing and Hunting Workers
12,Florida,454,2230,1560,670,97,0,432,120,89,31,5,1,19,45-4000,"Forest, Conservation, and Logging Workers"
12,Florida,471,44174,33006,11168,1951,1807,2208,2408,1916,492,69,84,83,47-1000,Supervisors of Construction and Extraction Workers
12,Florida,472,433071,242632,190439,47336,30280,44978,19220,12675,6545,1402,1082,1381,47-2000,Construction Trades Workers
12,Florida,473,4489,2706,1783,110,218,206,202,139,63,7,10,9,47-3000,"Helpers, Construction Trades"
12,Florida,474,20208,15523,4685,539,759,429,1033,824,209,23,42,11,47-4000,Other Construction and Related Workers
12,Florida,475,3173,2533,640,120,115,175,161,141,20,2,4,5,47-5000,Extraction Workers
12,Florida,491,15509,11755,3754,412,964,160,867,704,163,16,35,6,49-1000,"Supervisors of Installation, Maintenance, and Repair Workers"
12,Florida,492,33203,24655,8548,572,2273,444,1670,1289,381,30,96,14,49-2000,"Electrical and Electronic Equipment Mechanics, Installers, and Repairers"
12,Florida,493,111566,80080,31486,3856,5938,1759,5441,4141,1300,135,238,77,49-3000,"Vehicle and Mobile Equipment Mechanics, Installers, and Repairers"
12,Florida,499,138329,102637,35692,4154,6542,2342,6989,5495,1494,143,290,90,49-9000,"Other Installation, Maintenance, and Repair Occupations"
12,Florida,511,27237,20251,6986,723,1343,729,1567,1211,356,33,74,31,51-1000,Supervisors of Production Workers
12,Florida,512,32926,22873,10053,990,2029,721,1742,1260,482,42,90,30,51-2000,Assemblers and Fabricators
12,Florida,513,34277,23152,11125,896,2057,1083,1697,1224,473,36,85,48,51-3000,Food Processing Workers
12,Florida,514,42620,30770,11850,1346,1321,1392,2097,1591,506,49,65,50,51-4000,Metal Workers and Plastic Workers
12,Florida,5151,10607,7697,2910,258,321,269,522,398,124,9,19,11,51-5100,Printing Workers
12,Florida,516,27799,13092,14707,1769,2503,1397,1436,746,690,78,126,49,51-6000,"Textile, Apparel, and Furnishings Workers"
12,Florida,517,5135,3963,1172,112,245,186,300,245,55,4,15,8,51-7000,Woodworkers
12,Florida,518,11954,9591,2363,93,361,69,705,591,114,5,21,5,51-8000,Plant and System Operators
12,Florida,519,101612,67678,33934,3473,5524,3193,5355,3843,1512,139,262,136,51-9000,Other Production Occupations
12,Florida,531,15269,11195,4074,645,963,61,755,564,191,25,48,4,53-1000,Supervisors of Transportation and Material Moving Workers
12,Florida,532,30516,24288,6228,270,1858,56,1759,1438,321,15,94,3,53-2000,Air Transportation Workers
12,Florida,533,278294,173507,104787,7073,19703,4094,12892,8850,4042,288,787,153,53-3000,Motor Vehicle Operators
12,Florida,534,2865,2456,409,10,63,0,161,143,18,1,4,1,53-4000,Rail Transportation Workers
12,Florida,535,9295,8053,1242,301,84,0,524,454,70,11,6,0,53-5000,Water Transportation Workers
12,Florida,536,22541,15084,7457,834,1776,141,1025,741,284,32,79,4,53-6000,Other Transportation Workers
12,Florida,537,286789,217109,69680,7652,10643,6474,14428,11431,2997,310,503,256,53-7000,Material Moving Workers
13,Georgia,111,68592,61273,7319,177,599,562,3761,3364,397,10,35,24,11-1000,Top Executives
13,Georgia,112,37201,33422,3779,96,437,362,2072,1873,199,6,27,17,11-2000,"Advertising, Marketing, Promotions, Public Relations, and Sales Managers"
13,Georgia,113,101055,87625,13430,323,1008,1068,5552,4866,686,19,55,50,11-3000,Operations Specialties Managers
13,Georgia,119,269548,237525,32023,1784,2269,4869,14424,12942,1482,69,136,163,11-9000,Other Management Occupations
13,Georgia,131,152662,137317,15345,493,1667,774,8163,7387,776,22,86,40,13-1000,Business Operations Specialists
13,Georgia,132,97555,85857,11698,344,1087,431,5316,4725,591,21,54,22,13-2000,Financial Specialists
13,Georgia,1512,145106,106905,38201,294,1707,985,7354,5604,1750,15,79,41,15-1200,Computer Occupations
13,Georgia,152,8446,6977,1469,111,27,93,440,377,63,2,2,1,15-2000,Mathematical Science Occupations
13,Georgia,171,6358,4919,1439,48,148,51,372,298,74,2,10,2,17-1000,"Architects, Surveyors, and Cartographers"
13,Georgia,172,48763,39345,9418,99,696,397,2595,2153,442,6,31,18,17-2000,Engineers
13,Georgia,173,16770,15137,1633,26,136,354,937,847,90,3,7,12,17-3000,"Drafters, Engineering Technicians, and Mapping Technicians"
13,Georgia,191,7506,5670,1836,10,85,66,436,336,100,1,8,3,19-1000,Life Scientists
13,Georgia,192,9069,6558,2511,14,88,79,550,404,146,1,7,2,19-2000,Physical Scientists
13,Georgia,193,5744,5379,365,21,60,82,333,307,26,1,5,4,19-3000,Social Scientists and Related Workers
13,Georgia,194,10150,8803,1347,18,143,231,616,538,78,2,5,11,19-4000,"Life, Physical, and Social Science Technicians"
13,Georgia,195,1804,1541,263,0,36,40,94,87,7,0,1,2,19-5000,Occupational Health and Safety Specialists and Technicians
13,Georgia,211,48607,46054,2553,185,229,248,2598,2454,144,11,14,14,21-1000,"Counselors, Social Workers, and Other Community and Social Service Specialists"
13,Georgia,212,20391,18250,2141,319,198,102,1191,1085,106,11,12,7,21-2000,Religious Workers
13,Georgia,231,28200,26450,1750,0,213,59,1641,1554,87,0,11,2,23-1000,"Lawyers, Judges, and Related Workers"
13,Georgia,232,14999,13895,1104,78,173,92,817,751,66,2,7,7,23-2000,Legal Support Workers
13,Georgia,251,35574,26607,8967,36,502,194,2370,1799,571,5,31,16,25-1000,Postsecondary Teachers
13,Georgia,252,184935,173526,11409,328,1137,720,10665,10027,638,23,69,40,25-2000,"Preschool, Elementary, Middle, Secondary, and Special Education Teachers"
13,Georgia,253,26481,24072,2409,62,157,289,1625,1489,136,3,12,13,25-3000,Other Teachers and Instructors
13,Georgia,254,5931,5500,431,0,0,0,418,383,35,0,1,1,25-4000,"Librarians, Curators, and Archivists"
13,Georgia,259,36585,33598,2987,212,289,133,2318,2124,194,8,20,15,25-9000,Other Educational Instruction and Library Occupations
13,Georgia,271,28140,24453,3687,244,347,327,1693,1474,219,7,24,15,27-1000,Art and Design Workers
13,Georgia,272,24842,22754,2088,121,168,78,1622,1503,119,2,13,6,27-2000,"Entertainers and Performers, Sports and Related Workers"
13,Georgia,273,19445,17303,2142,79,562,377,1188,1061,127,9,25,18,27-3000,Media and Communication Workers
13,Georgia,274,10104,9351,753,10,220,180,628,584,44,3,7,10,27-4000,Media and Communication Equipment Workers
13,Georgia,291,166486,144596,21890,437,1289,390,9159,8072,1087,25,70,29,29-1000,Healthcare Diagnosing or Treating Practitioners
13,Georgia,292,81505,73966,7539,185,354,278,4262,3944,318,11,16,15,29-2000,Health Technologists and Technicians
13,Georgia,299,2469,2346,123,0,15,0,127,120,7,0,1,0,29-9000,Other Healthcare Practitioners and Technical Occupations
13,Georgia,3111,62906,54281,8625,117,296,571,3259,2885,374,11,18,24,31-1100,"Home Health and Personal Care Aides; and Nursing Assistants, Orderlies, and Psychiatric Aides"
13,Georgia,312,3105,2934,171,0,0,0,145,138,7,0,0,0,31-2000,Occupational Therapy and Physical Therapist Assistants and Aides
13,Georgia,319,39388,34212,5176,266,563,680,2022,1794,228,10,24,35,31-9000,Other Healthcare Support Occupations
13,Georgia,331,9006,8763,243,0,18,59,518,512,6,0,1,1,33-1000,Supervisors of Protective Service Workers
13,Georgia,332,11618,11473,145,0,0,36,600,588,12,0,0,3,33-2000,Firefighting and Prevention Workers
13,Georgia,333,45397,43593,1804,116,114,340,2285,2208,77,4,7,11,33-3000,Law Enforcement Workers
13,Georgia,339,35376,33335,2041,22,254,113,1968,1864,104,3,10,7,33-9000,Other Protective Service Workers
13,Georgia,351,30681,24158,6523,257,136,1681,1551,1266,285,10,6,59,35-1000,Supervisors of Food Preparation and Serving Workers
13,Georgia,352,105172,86446,18726,1875,602,9350,5587,4799,788,82,28,338,35-2000,Cooks and Food Preparation Workers
13,Georgia,353,102824,90741,12083,858,979,3825,5829,5268,561,39,56,139,35-3000,Food and Beverage Serving Workers
13,Georgia,359,25434,22523,2911,502,208,988,1593,1443,150,19,15,49,35-9000,Other Food Preparation and Serving Related Workers
13,Georgia,371,13506,11105,2401,590,521,856,671,577,94,18,18,27,37-1000,Supervisors of Building and Grounds Cleaning and Maintenance Workers
13,Georgia,372,111136,81794,29342,5403,4211,12761,6113,4911,1202,213,169,517,37-2000,Building Cleaning and Pest Control Workers
13,Georgia,373,43717,29675,14042,3779,360,8985,2295,1837,458,119,14,272,37-3000,Grounds Maintenance Workers
13,Georgia,391,2955,2415,540,0,19,50,128,110,18,0,1,1,39-1000,Supervisors of Personal Care and Service Workers
13,Georgia,392,9807,8888,919,25,153,47,574,535,39,2,4,3,39-2000,Animal Care and Service Workers
13,Georgia,393,6211,5465,746,0,0,215,414,382,32,0,0,6,39-3000,Entertainment Attendants and Related Workers
13,Georgia,394,1814,1729,85,0,0,0,84,82,2,0,0,0,39-4000,Funeral Service Workers
13,Georgia,395,44153,31443,12710,221,377,578,2051,1499,552,10,16,21,39-5000,Personal Appearance Workers
13,Georgia,396,2350,2205,145,0,0,0,114,107,7,0,0,0,39-6000,"Baggage Porters, Bellhops, and Concierges"
13,Georgia,397,1254,1201,53,0,21,0,101,97,4,1,1,0,39-7000,Tour and Travel Guides
13,Georgia,399,45146,40016,5130,375,842,750,3121,2843,278,15,48,43,39-9000,Other Personal Care and Service Workers
13,Georgia,411,143614,125621,17993,535,1206,2030,7347,6525,822,30,60,85,41-1000,Supervisors of Sales Workers
13,Georgia,412,211335,186515,24820,1712,1593,3944,12543,11262,1281,79,98,185,41-2000,Retail Sales Workers
13,Georgia,413,52700,48340,4360,192,452,427,2873,2643,230,9,23,18,41-3000,"Sales Representatives, Services"
13,Georgia,414,42226,38988,3238,193,353,460,2328,2162,166,6,16,23,41-4000,"Sales Representatives, Wholesale and Manufacturing"
13,Georgia,419,42537,38676,3861,69,412,408,2430,2192,238,5,25,22,41-9000,Other Sales and Related Workers
13,Georgia,431,41692,38436,3256,252,316,356,2198,2046,152,8,17,17,43-1000,Supervisors of Office and Administrative Support Workers
13,Georgia,432,2884,2716,168,0,30,0,164,150,14,0,2,0,43-2000,Communications Equipment Operators
13,Georgia,433,69787,63344,6443,391,922,989,3976,3670,306,16,43,44,43-3000,Financial Clerks
13,Georgia,434,172188,157140,15048,1117,1449,2739,9214,8471,743,47,75,119,43-4000,Information and Record Clerks
13,Georgia,435,64585,57977,6608,463,426,1481,3386,3103,283,21,14,60,43-5000,"Material Recording, Scheduling, Dispatching, and Distributing Workers"
13,Georgia,436,80013,74824,5189,303,673,557,5137,4838,299,23,34,31,43-6000,Secretaries and Administrative Assistants
13,Georgia,439,84183,76421,7762,386,815,847,4920,4536,384,16,42,40,43-9000,Other Office and Administrative Support Workers
13,Georgia,451,1447,1319,128,0,21,58,86,79,7,0,1,4,45-1000,"Supervisors of Farming, Fishing, and Forestry Workers"
13,Georgia,452,20044,11999,8045,1021,69,6352,1195,842,353,37,4,285,45-2000,Agricultural Workers
13,Georgia,453,304,304,0,0,0,0,25,25,0,0,0,0,45-3000,Fishing and Hunting Workers
13,Georgia,454,3295,2963,332,0,0,266,206,190,16,0,0,12,45-4000,"Forest, Conservation, and Logging Workers"
13,Georgia,471,22324,18882,3442,533,168,2038,1228,1085,143,21,7,84,47-1000,Supervisors of Construction and Extraction Workers
13,Georgia,472,198738,128253,70485,15451,3318,45220,9250,7023,2227,489,119,1351,47-2000,Construction Trades Workers
13,Georgia,473,1854,1412,442,132,17,252,109,90,19,5,1,11,47-3000,"Helpers, Construction Trades"
13,Georgia,474,8700,7115,1585,362,72,866,434,384,50,11,3,26,47-4000,Other Construction and Related Workers
13,Georgia,475,2097,1944,153,0,0,153,121,115,6,0,0,6,47-5000,Extraction Workers
13,Georgia,491,8996,8320,676,56,156,66,473,440,33,1,6,4,49-1000,"Supervisors of Installation, Maintenance, and Repair Workers"
13,Georgia,492,16283,14145,2138,144,25,485,823,752,71,6,1,10,49-2000,"Electrical and Electronic Equipment Mechanics, Installers, and Repairers"
13,Georgia,493,59276,51928,7348,1205,482,2485,3048,2765,283,35,19,83,49-3000,"Vehicle and Mobile Equipment Mechanics, Installers, and Repairers"
13,Georgia,499,74811,65863,8948,1196,1222,2620,3951,3605,346,42,33,105,49-9000,"Other Installation, Maintenance, and Repair Occupations"
13,Georgia,511,31737,27729,4008,509,219,1566,1681,1516,165,17,8,57,51-1000,Supervisors of Production Workers
13,Georgia,512,35640,28690,6950,789,508,2531,1767,1463,304,31,21,95,51-2000,Assemblers and Fabricators
13,Georgia,513,29374,21136,8238,1086,364,3231,1409,1072,337,35,14,117,51-3000,Food Processing Workers
13,Georgia,514,42261,37055,5206,639,248,2308,2236,2009,227,26,11,85,51-4000,Metal Workers and Plastic Workers
13,Georgia,5151,5711,4882,829,73,27,340,290,254,36,2,1,17,51-5100,Printing Workers
13,Georgia,516,28183,17336,10847,1698,142,6061,1457,1041,416,52,9,222,51-6000,"Textile, Apparel, and Furnishings Workers"
13,Georgia,517,4986,4225,761,52,144,320,249,216,33,3,5,14,51-7000,Woodworkers
13,Georgia,518,7540,6997,543,72,48,60,424,397,27,2,2,3,51-8000,Plant and System Operators
13,Georgia,519,106948,87002,19946,2734,588,8846,5405,4573,832,97,26,339,51-9000,Other Production Occupations
13,Georgia,531,9537,8387,1150,52,79,14,456,410,46,1,5,2,53-1000,Supervisors of Transportation and Material Moving Workers
13,Georgia,532,15183,13408,1775,109,152,41,841,757,84,4,11,3,53-2000,Air Transportation Workers
13,Georgia,533,157304,137516,19788,2146,1684,2434,7549,6836,713,60,58,88,53-3000,Motor Vehicle Operators
13,Georgia,534,3802,3656,146,0,34,0,195,187,8,0,1,0,53-4000,Rail Transportation Workers
13,Georgia,535,468,412,56,0,56,0,35,32,3,0,2,0,53-5000,Water Transportation Workers
13,Georgia,536,9081,8277,804,0,8,47,463,420,43,0,3,4,53-6000,Other Transportation Workers
13,Georgia,537,201599,173904,27695,3637,1486,10840,10399,9229,1170,137,63,409,53-7000,Material Moving Workers
15,Hawaii,111,7735,6645,1090,0,34,0,435,372,63,0,1,0,11-1000,Top Executives
15,Hawaii,112,3067,2728,339,0,0,14,159,131,28,0,0,1,11-2000,"Advertising, Marketing, Promotions, Public Relations, and Sales Managers"
15,Hawaii,113,9458,8254,1204,9,42,0,511,438,73,1,2,3,11-3000,Operations Specialties Managers
15,Hawaii,119,36428,29569,6859,57,89,52,2030,1687,343,3,8,2,11-9000,Other Management Occupations
15,Hawaii,131,16042,13748,2294,48,37,0,906,788,118,1,1,0,13-1000,Business Operations Specialists
15,Hawaii,132,11418,8833,2585,0,0,0,655,518,137,0,0,0,13-2000,Financial Specialists
15,Hawaii,1512,11174,9677,1497,0,88,6,641,552,89,0,5,1,15-1200,Computer Occupations
15,Hawaii,152,954,876,78,0,8,0,62,56,6,0,1,0,15-2000,Mathematical Science Occupations
15,Hawaii,171,1180,933,247,0,0,0,67,55,12,0,0,0,17-1000,"Architects, Surveyors, and Cartographers"
15,Hawaii,172,6333,5300,1033,0,8,0,356,291,65,0,1,1,17-2000,Engineers
15,Hawaii,173,3019,2473,546,0,0,0,166,135,31,0,0,0,17-3000,"Drafters, Engineering Technicians, and Mapping Technicians"
15,Hawaii,191,1273,1119,154,0,36,0,71,62,9,0,1,0,19-1000,Life Scientists
15,Hawaii,192,1550,1152,398,0,0,0,77,54,23,0,0,0,19-2000,Physical Scientists
15,Hawaii,193,1439,1399,40,0,0,0,75,71,4,0,0,0,19-3000,Social Scientists and Related Workers
15,Hawaii,194,1666,1363,303,0,0,18,86,73,13,0,0,1,19-4000,"Life, Physical, and Social Science Technicians"
15,Hawaii,195,459,386,73,0,0,0,26,22,4,0,0,0,19-5000,Occupational Health and Safety Specialists and Technicians
15,Hawaii,211,9191,8254,937,0,30,0,537,487,50,0,2,0,21-1000,"Counselors, Social Workers, and Other Community and Social Service Specialists"
15,Hawaii,212,1506,1063,443,0,90,0,111,78,33,0,3,0,21-2000,Religious Workers
15,Hawaii,231,3121,2884,237,0,0,0,175,163,12,0,0,0,23-1000,"Lawyers, Judges, and Related Workers"
15,Hawaii,232,1646,1313,333,18,0,0,100,80,20,1,0,0,23-2000,Legal Support Workers
15,Hawaii,251,4897,3380,1517,0,30,0,322,228,94,0,2,0,25-1000,Postsecondary Teachers
15,Hawaii,252,20607,18961,1646,0,62,29,1287,1172,115,0,2,1,25-2000,"Preschool, Elementary, Middle, Secondary, and Special Education Teachers"
15,Hawaii,253,4691,4070,621,0,0,113,289,248,41,0,0,3,25-3000,Other Teachers and Instructors
15,Hawaii,254,1346,1219,127,0,0,0,86,78,8,0,0,0,25-4000,"Librarians, Curators, and Archivists"
15,Hawaii,259,6963,5940,1023,0,66,72,437,377,60,1,6,1,25-9000,Other Educational Instruction and Library Occupations
15,Hawaii,271,4248,3436,812,3,0,39,226,182,44,1,0,1,27-1000,Art and Design Workers
15,Hawaii,272,2919,2630,289,57,0,0,228,201,27,2,1,1,27-2000,"Entertainers and Performers, Sports and Related Workers"
15,Hawaii,273,2822,2440,382,0,15,0,170,139,31,1,2,0,27-3000,Media and Communication Workers
15,Hawaii,274,2437,2090,347,0,0,0,131,116,15,0,0,0,27-4000,Media and Communication Equipment Workers
15,Hawaii,291,25156,19942,5214,12,81,13,1381,1118,263,2,5,1,29-1000,Healthcare Diagnosing or Treating Practitioners
15,Hawaii,292,9020,7554,1466,0,0,0,491,416,75,0,0,0,29-2000,Health Technologists and Technicians
15,Hawaii,299,407,394,13,0,0,0,21,20,1,0,0,0,29-9000,Other Healthcare Practitioners and Technical Occupations
15,Hawaii,3111,8786,4955,3831,0,0,0,506,311,195,0,1,1,31-1100,"Home Health and Personal Care Aides; and Nursing Assistants, Orderlies, and Psychiatric Aides"
15,Hawaii,312,717,517,200,0,0,0,34,27,7,0,0,0,31-2000,Occupational Therapy and Physical Therapist Assistants and Aides
15,Hawaii,319,7492,5254,2238,0,23,56,422,307,115,0,1,3,31-9000,Other Healthcare Support Occupations
15,Hawaii,331,1077,908,169,0,82,0,79,74,5,0,1,0,33-1000,Supervisors of Protective Service Workers
15,Hawaii,332,2312,2192,120,0,0,0,130,126,4,0,0,0,33-2000,Firefighting and Prevention Workers
15,Hawaii,333,5910,5286,624,0,0,13,309,279,30,0,0,1,33-3000,Law Enforcement Workers
15,Hawaii,339,10427,8796,1631,16,0,0,546,476,70,1,0,0,33-9000,Other Protective Service Workers
15,Hawaii,351,6248,4094,2154,0,34,19,338,223,115,0,2,2,35-1000,Supervisors of Food Preparation and Serving Workers
15,Hawaii,352,20283,11964,8319,0,44,451,1027,685,342,0,3,10,35-2000,Cooks and Food Preparation Workers
15,Hawaii,353,22106,17877,4229,0,90,194,1070,873,197,0,4,4,35-3000,Food and Beverage Serving Workers
15,Hawaii,359,6163,4788,1375,0,0,21,358,292,66,0,0,1,35-9000,Other Food Preparation and Serving Related Workers
15,Hawaii,371,1804,1328,476,0,11,11,113,84,29,0,1,1,37-1000,Supervisors of Building and Grounds Cleaning and Maintenance Workers
15,Hawaii,372,23679,10379,13300,212,107,519,1179,623,556,5,5,17,37-2000,Building Cleaning and Pest Control Workers
15,Hawaii,373,9051,5437,3614,0,16,347,476,336,140,0,1,7,37-3000,Grounds Maintenance Workers
15,Hawaii,391,254,254,0,0,0,0,6,6,0,0,0,0,39-1000,Supervisors of Personal Care and Service Workers
15,Hawaii,392,1032,996,36,0,0,0,56,52,4,0,0,0,39-2000,Animal Care and Service Workers
15,Hawaii,393,1700,1502,198,0,0,0,91,85,6,0,0,0,39-3000,Entertainment Attendants and Related Workers
15,Hawaii,394,190,152,38,0,0,0,11,8,3,0,0,0,39-4000,Funeral Service Workers
15,Hawaii,395,4987,2549,2438,0,0,0,244,144,100,0,0,1,39-5000,Personal Appearance Workers
15,Hawaii,396,2165,1811,354,0,0,0,119,97,22,1,0,0,39-6000,"Baggage Porters, Bellhops, and Concierges"
15,Hawaii,397,1943,1452,491,0,0,0,91,66,25,0,0,0,39-7000,Tour and Travel Guides
15,Hawaii,399,7887,6375,1512,22,68,32,504,418,86,1,6,2,39-9000,Other Personal Care and Service Workers
15,Hawaii,411,17475,14352,3123,0,179,35,910,742,168,0,6,4,41-1000,Supervisors of Sales Workers
15,Hawaii,412,34708,25096,9612,21,76,117,1988,1495,493,2,6,6,41-2000,Retail Sales Workers
15,Hawaii,413,5180,4164,1016,0,53,0,284,227,57,0,4,0,41-3000,"Sales Representatives, Services"
15,Hawaii,414,3796,3423,373,54,10,0,207,182,25,1,1,0,41-4000,"Sales Representatives, Wholesale and Manufacturing"
15,Hawaii,419,6188,5018,1170,7,37,71,353,286,67,1,1,1,41-9000,Other Sales and Related Workers
15,Hawaii,431,6167,5474,693,0,83,0,354,312,42,0,3,0,43-1000,Supervisors of Office and Administrative Support Workers
15,Hawaii,432,465,348,117,0,0,0,27,21,6,0,0,0,43-2000,Communications Equipment Operators
15,Hawaii,433,9445,7483,1962,0,154,13,507,405,102,0,1,1,43-3000,Financial Clerks
15,Hawaii,434,23920,19388,4532,4,97,53,1424,1183,241,2,5,3,43-4000,Information and Record Clerks
15,Hawaii,435,6312,5421,891,0,0,136,371,331,40,0,0,3,43-5000,"Material Recording, Scheduling, Dispatching, and Distributing Workers"
15,Hawaii,436,11526,9946,1580,5,0,8,733,639,94,2,1,1,43-6000,Secretaries and Administrative Assistants
15,Hawaii,439,16893,13753,3140,0,6,79,1004,840,164,0,2,3,43-9000,Other Office and Administrative Support Workers
15,Hawaii,451,290,166,124,0,0,0,16,11,5,0,0,0,45-1000,"Supervisors of Farming, Fishing, and Forestry Workers"
15,Hawaii,452,3744,1984,1760,111,0,146,227,146,81,1,0,6,45-2000,Agricultural Workers
15,Hawaii,453,723,507,216,0,0,0,31,25,6,0,0,0,45-3000,Fishing and Hunting Workers
15,Hawaii,454,134,126,8,0,0,0,7,6,1,0,0,0,45-4000,"Forest, Conservation, and Logging Workers"
15,Hawaii,471,3013,2589,424,0,0,76,160,143,17,0,0,2,47-1000,Supervisors of Construction and Extraction Workers
15,Hawaii,472,32739,26794,5945,190,132,602,1790,1521,269,5,6,16,47-2000,Construction Trades Workers
15,Hawaii,473,208,193,15,0,0,0,8,7,1,0,0,0,47-3000,"Helpers, Construction Trades"
15,Hawaii,474,2178,1885,293,0,0,67,119,107,12,0,0,1,47-4000,Other Construction and Related Workers
15,Hawaii,475,158,144,14,0,0,0,8,7,1,0,0,0,47-5000,Extraction Workers
15,Hawaii,491,1217,1031,186,0,0,0,64,57,7,0,0,0,49-1000,"Supervisors of Installation, Maintenance, and Repair Workers"
15,Hawaii,492,2109,1990,119,0,0,0,112,102,10,0,0,0,49-2000,"Electrical and Electronic Equipment Mechanics, Installers, and Repairers"
15,Hawaii,493,8818,7496,1322,0,45,29,407,344,63,0,2,1,49-3000,"Vehicle and Mobile Equipment Mechanics, Installers, and Repairers"
15,Hawaii,499,8318,6728,1590,0,0,58,444,369,75,0,0,2,49-9000,"Other Installation, Maintenance, and Repair Occupations"
15,Hawaii,511,1356,1285,71,0,0,0,96,85,11,1,0,0,51-1000,Supervisors of Production Workers
15,Hawaii,512,936,763,173,0,8,0,47,39,8,0,1,0,51-2000,Assemblers and Fabricators
15,Hawaii,513,3676,2206,1470,0,0,0,184,127,57,0,1,0,51-3000,Food Processing Workers
15,Hawaii,514,1511,1125,386,0,0,15,80,55,25,0,0,1,51-4000,Metal Workers and Plastic Workers
15,Hawaii,5151,537,403,134,0,0,0,35,26,9,0,0,0,51-5100,Printing Workers
15,Hawaii,516,2141,595,1546,0,36,63,130,49,81,0,1,1,51-6000,"Textile, Apparel, and Furnishings Workers"
15,Hawaii,517,358,358,0,0,0,0,23,21,2,0,0,0,51-7000,Woodworkers
15,Hawaii,518,1335,1218,117,0,0,0,79,72,7,0,0,0,51-8000,Plant and System Operators
15,Hawaii,519,4529,3438,1091,0,0,79,253,196,57,0,0,2,51-9000,Other Production Occupations
15,Hawaii,531,993,842,151,0,7,0,62,55,7,0,1,0,53-1000,Supervisors of Transportation and Material Moving Workers
15,Hawaii,532,4130,3452,678,0,11,0,211,180,31,0,1,0,53-2000,Air Transportation Workers
15,Hawaii,533,16273,11859,4414,0,0,124,892,712,180,0,0,4,53-3000,Motor Vehicle Operators
15,Hawaii,534,221,213,8,0,0,0,8,6,2,0,0,0,53-4000,Rail Transportation Workers
15,Hawaii,535,847,802,45,0,0,0,62,57,5,0,0,0,53-5000,Water Transportation Workers
15,Hawaii,536,1940,1699,241,0,0,0,106,88,18,0,0,0,53-6000,Other Transportation Workers
15,Hawaii,537,17741,13988,3753,129,0,84,1002,823,179,1,0,5,53-7000,Material Moving Workers
16,Idaho,111,9249,9068,181,0,0,44,446,436,10,0,0,2,11-1000,Top Executives
16,Idaho,112,3771,3543,228,0,26,66,192,184,8,0,1,2,11-2000,"Advertising, Marketing, Promotions, Public Relations, and Sales Managers"
16,Idaho,113,13335,12711,624,0,32,154,624,597,27,0,2,5,11-3000,Operations Specialties Managers
16,Idaho,119,47225,44345,2880,35,161,1441,2637,2516,121,3,3,54,11-9000,Other Management Occupations
16,Idaho,131,18435,17877,558,0,0,201,936,907,29,0,2,8,13-1000,Business Operations Specialists
16,Idaho,132,11503,11122,381,19,2,60,607,585,22,1,1,3,13-2000,Financial Specialists
16,Idaho,1512,16845,15929,916,32,29,114,786,754,32,1,1,4,15-1200,Computer Occupations
16,Idaho,152,661,661,0,0,0,0,38,38,0,0,0,0,15-2000,Mathematical Science Occupations
16,Idaho,171,1457,1457,0,0,0,0,59,59,0,0,0,0,17-1000,"Architects, Surveyors, and Cartographers"
16,Idaho,172,10314,8733,1581,0,107,97,490,429,61,0,4,3,17-2000,Engineers
16,Idaho,173,4002,3915,87,0,7,25,213,201,12,0,4,2,17-3000,"Drafters, Engineering Technicians, and Mapping Technicians"
16,Idaho,191,1858,1727,131,0,0,0,127,120,7,0,0,0,19-1000,Life Scientists
16,Idaho,192,1621,1377,244,0,0,0,88,76,12,0,0,0,19-2000,Physical Scientists
16,Idaho,193,696,636,60,0,0,0,45,41,4,0,1,0,19-3000,Social Scientists and Related Workers
16,Idaho,194,2836,2773,63,10,0,10,184,178,6,1,0,1,19-4000,"Life, Physical, and Social Science Technicians"
16,Idaho,195,261,261,0,0,0,0,20,20,0,0,0,0,19-5000,Occupational Health and Safety Specialists and Technicians
16,Idaho,211,9852,9589,263,0,0,71,523,506,17,0,1,2,21-1000,"Counselors, Social Workers, and Other Community and Social Service Specialists"
16,Idaho,212,2415,2359,56,0,56,0,121,119,2,0,2,0,21-2000,Religious Workers
16,Idaho,231,3394,3331,63,0,14,0,163,160,3,0,1,0,23-1000,"Lawyers, Judges, and Related Workers"
16,Idaho,232,2571,2482,89,0,0,89,124,122,2,0,0,2,23-2000,Legal Support Workers
16,Idaho,251,5928,5157,771,0,7,0,321,286,35,0,1,0,25-1000,Postsecondary Teachers
16,Idaho,252,24536,23998,538,0,38,86,1465,1430,35,1,3,5,25-2000,"Preschool, Elementary, Middle, Secondary, and Special Education Teachers"
16,Idaho,253,4636,4549,87,20,0,36,273,265,8,1,0,2,25-3000,Other Teachers and Instructors
16,Idaho,254,1983,1954,29,0,0,0,125,121,4,0,1,0,25-4000,"Librarians, Curators, and Archivists"
16,Idaho,259,6955,6455,500,4,31,184,442,421,21,1,2,8,25-9000,Other Educational Instruction and Library Occupations
16,Idaho,271,5030,4821,209,0,0,122,252,241,11,0,1,5,27-1000,Art and Design Workers
16,Idaho,272,2372,2372,0,0,0,0,147,146,1,0,0,0,27-2000,"Entertainers and Performers, Sports and Related Workers"
16,Idaho,273,3296,3041,255,0,59,40,178,166,12,0,3,3,27-3000,Media and Communication Workers
16,Idaho,274,1349,1349,0,0,0,0,85,85,0,0,0,0,27-4000,Media and Communication Equipment Workers
16,Idaho,291,28233,26866,1367,17,10,106,1454,1400,54,1,1,5,29-1000,Healthcare Diagnosing or Treating Practitioners
16,Idaho,292,14261,13493,768,0,16,253,678,640,38,0,1,11,29-2000,Health Technologists and Technicians
16,Idaho,299,237,237,0,0,0,0,15,15,0,0,0,0,29-9000,Other Healthcare Practitioners and Technical Occupations
16,Idaho,3111,16739,15791,948,0,9,449,980,935,45,0,1,18,31-1100,"Home Health and Personal Care Aides; and Nursing Assistants, Orderlies, and Psychiatric Aides"
16,Idaho,312,755,755,0,0,0,0,58,58,0,0,0,0,31-2000,Occupational Therapy and Physical Therapist Assistants and Aides
16,Idaho,319,8322,7785,537,0,0,197,425,403,22,0,1,11,31-9000,Other Healthcare Support Occupations
16,Idaho,331,1272,1248,24,0,0,24,75,73,2,0,0,2,33-1000,Supervisors of Protective Service Workers
16,Idaho,332,2622,2537,85,0,0,85,144,141,3,0,0,2,33-2000,Firefighting and Prevention Workers
16,Idaho,333,5822,5767,55,0,0,14,294,290,4,0,0,2,33-3000,Law Enforcement Workers
16,Idaho,339,3960,3655,305,0,42,222,280,274,6,0,1,3,33-9000,Other Protective Service Workers
16,Idaho,351,4713,4553,160,0,0,11,245,235,10,0,0,2,35-1000,Supervisors of Food Preparation and Serving Workers
16,Idaho,352,18962,16913,2049,10,100,1326,1075,980,95,2,4,43,35-2000,Cooks and Food Preparation Workers
16,Idaho,353,15518,14372,1146,100,165,426,872,824,48,2,3,24,35-3000,Food and Beverage Serving Workers
16,Idaho,359,4198,4021,177,0,0,177,292,282,10,0,0,6,35-9000,Other Food Preparation and Serving Related Workers
16,Idaho,371,2384,2061,323,0,69,227,125,112,13,0,2,9,37-1000,Supervisors of Building and Grounds Cleaning and Maintenance Workers
16,Idaho,372,18931,15952,2979,121,236,1958,1166,1049,117,4,6,74,37-2000,Building Cleaning and Pest Control Workers
16,Idaho,373,7302,5895,1407,0,8,1381,465,421,44,1,1,40,37-3000,Grounds Maintenance Workers
16,Idaho,391,295,295,0,0,0,0,13,13,0,0,0,0,39-1000,Supervisors of Personal Care and Service Workers
16,Idaho,392,2248,2190,58,0,0,26,136,130,6,0,0,2,39-2000,Animal Care and Service Workers
16,Idaho,393,1576,1461,115,0,0,44,89,82,7,1,0,2,39-3000,Entertainment Attendants and Related Workers
16,Idaho,394,279,273,6,0,0,0,14,13,1,0,0,0,39-4000,Funeral Service Workers
16,Idaho,395,5225,4877,348,0,0,172,273,256,17,0,0,6,39-5000,Personal Appearance Workers
16,Idaho,396,77,77,0,0,0,0,3,3,0,0,0,0,39-6000,"Baggage Porters, Bellhops, and Concierges"
16,Idaho,397,664,623,41,0,41,0,41,39,2,0,1,0,39-7000,Tour and Travel Guides
16,Idaho,399,8807,8029,778,0,243,229,592,566,26,1,1,12,39-9000,Other Personal Care and Service Workers
16,Idaho,411,22353,21464,889,27,0,269,1099,1073,26,1,0,8,41-1000,Supervisors of Sales Workers
16,Idaho,412,32082,30678,1404,38,193,428,1750,1685,65,1,3,25,41-2000,Retail Sales Workers
16,Idaho,413,7150,7054,96,0,12,19,334,325,9,0,1,2,41-3000,"Sales Representatives, Services"
16,Idaho,414,6760,6659,101,0,0,13,335,328,7,0,1,1,41-4000,"Sales Representatives, Wholesale and Manufacturing"
16,Idaho,419,8151,7879,272,0,44,152,364,351,13,0,2,5,41-9000,Other Sales and Related Workers
16,Idaho,431,6314,6061,253,0,0,123,317,310,7,0,0,4,43-1000,Supervisors of Office and Administrative Support Workers
16,Idaho,432,561,530,31,0,0,31,30,29,1,0,0,1,43-2000,Communications Equipment Operators
16,Idaho,433,13876,13234,642,19,85,312,780,757,23,1,3,8,43-3000,Financial Clerks
16,Idaho,434,30461,28590,1871,76,257,839,1530,1462,68,2,9,26,43-4000,Information and Record Clerks
16,Idaho,435,10254,9819,435,0,2,232,574,555,19,0,1,10,43-5000,"Material Recording, Scheduling, Dispatching, and Distributing Workers"
16,Idaho,436,15689,14967,722,0,14,426,998,967,31,0,1,12,43-6000,Secretaries and Administrative Assistants
16,Idaho,439,10869,10501,368,0,32,105,689,667,22,0,1,5,43-9000,Other Office and Administrative Support Workers
16,Idaho,451,1031,863,168,0,0,168,81,72,9,1,0,8,45-1000,"Supervisors of Farming, Fishing, and Forestry Workers"
16,Idaho,452,15856,7082,8774,147,181,8416,1017,658,359,7,10,334,45-2000,Agricultural Workers
16,Idaho,453,65,65,0,0,0,0,11,11,0,0,0,0,45-3000,Fishing and Hunting Workers
16,Idaho,454,1120,1118,2,0,0,2,126,125,1,0,0,1,45-4000,"Forest, Conservation, and Logging Workers"
16,Idaho,471,3654,3422,232,7,0,225,232,222,10,1,0,9,47-1000,Supervisors of Construction and Extraction Workers
16,Idaho,472,35213,31265,3948,327,123,3132,1945,1828,117,7,3,93,47-2000,Construction Trades Workers
16,Idaho,473,51,51,0,0,0,0,3,3,0,0,0,0,47-3000,"Helpers, Construction Trades"
16,Idaho,474,2400,2196,204,0,0,204,149,144,5,0,0,5,47-4000,Other Construction and Related Workers
16,Idaho,475,1744,1601,143,0,0,93,113,108,5,0,0,4,47-5000,Extraction Workers
16,Idaho,491,1406,1206,200,0,200,0,82,81,1,0,1,0,49-1000,"Supervisors of Installation, Maintenance, and Repair Workers"
16,Idaho,492,2309,2022,287,0,0,99,128,119,9,0,0,3,49-2000,"Electrical and Electronic Equipment Mechanics, Installers, and Repairers"
16,Idaho,493,11376,10827,549,26,0,485,593,570,23,2,0,18,49-3000,"Vehicle and Mobile Equipment Mechanics, Installers, and Repairers"
16,Idaho,499,11023,9716,1307,70,0,884,617,578,39,1,0,26,49-9000,"Other Installation, Maintenance, and Repair Occupations"
16,Idaho,511,4231,3469,762,0,0,547,234,208,26,0,0,17,51-1000,Supervisors of Production Workers
16,Idaho,512,4361,3645,716,0,0,561,217,196,21,0,0,15,51-2000,Assemblers and Fabricators
16,Idaho,513,5007,3846,1161,0,47,959,261,221,40,0,2,34,51-3000,Food Processing Workers
16,Idaho,514,8551,7893,658,43,0,430,436,408,28,1,0,17,51-4000,Metal Workers and Plastic Workers
16,Idaho,5151,760,760,0,0,0,0,46,45,1,0,0,0,51-5100,Printing Workers
16,Idaho,516,2479,2142,337,0,0,286,137,121,16,0,1,10,51-6000,"Textile, Apparel, and Furnishings Workers"
16,Idaho,517,1420,1281,139,50,0,32,93,87,6,1,0,2,51-7000,Woodworkers
16,Idaho,518,1368,1318,50,0,0,0,103,101,2,0,0,0,51-8000,Plant and System Operators
16,Idaho,519,16053,14089,1964,56,45,1481,847,769,78,2,3,57,51-9000,Other Production Occupations
16,Idaho,531,962,962,0,0,0,0,51,51,0,0,0,0,53-1000,Supervisors of Transportation and Material Moving Workers
16,Idaho,532,1464,1383,81,0,0,0,64,58,6,0,0,1,53-2000,Air Transportation Workers
16,Idaho,533,26454,24430,2024,66,41,1536,1392,1324,68,3,1,46,53-3000,Motor Vehicle Operators
16,Idaho,534,682,675,7,0,0,0,55,54,1,0,0,0,53-4000,Rail Transportation Workers
16,Idaho,535,95,95,0,0,0,0,6,6,0,0,0,0,53-5000,Water Transportation Workers
16,Idaho,536,1305,1228,77,0,0,74,68,64,4,0,0,3,53-6000,Other Transportation Workers
16,Idaho,537,28734,25182,3552,93,53,2733,1603,1460,143,5,8,95,53-7000,Material Moving Workers
17,Illinois,111,86237,75423,10814,190,489,1405,4642,4135,507,5,29,57,11-1000,Top Executives
17,Illinois,112,55268,50047,5221,114,195,526,2870,2617,253,5,13,22,11-2000,"Advertising, Marketing, Promotions, Public Relations, and Sales Managers"
17,Illinois,113,133747,112178,21569,768,985,3458,7261,6235,1026,24,55,134,11-3000,Operations Specialties Managers
17,Illinois,119,327150,282756,44394,1351,2154,9975,17938,15913,2025,56,86,382,11-9000,Other Management Occupations
17,Illinois,131,203955,179244,24711,683,1557,3438,11089,9896,1193,28,79,143,13-1000,Business Operations Specialists
17,Illinois,132,145431,124538,20893,312,552,2368,7869,6835,1034,17,28,96,13-2000,Financial Specialists
17,Illinois,1512,183978,132870,51108,536,887,2365,9505,7182,2323,17,49,110,15-1200,Computer Occupations
17,Illinois,152,12304,9510,2794,47,54,153,655,523,132,2,3,6,15-2000,Mathematical Science Occupations
17,Illinois,171,10932,9019,1913,0,65,174,596,492,104,0,5,9,17-1000,"Architects, Surveyors, and Cartographers"
17,Illinois,172,69762,53538,16224,176,431,998,3711,2984,727,10,23,44,17-2000,Engineers
17,Illinois,173,18954,16210,2744,55,139,676,1202,1069,133,3,5,30,17-3000,"Drafters, Engineering Technicians, and Mapping Technicians"
17,Illinois,191,8028,5708,2320,20,24,51,463,349,114,1,2,2,19-1000,Life Scientists
17,Illinois,192,17208,10680,6528,17,239,80,881,590,291,1,9,4,19-2000,Physical Scientists
17,Illinois,193,10890,9749,1141,42,127,44,585,530,55,1,6,2,19-3000,Social Scientists and Related Workers
17,Illinois,194,12308,10008,2300,34,142,525,792,684,108,2,6,15,19-4000,"Life, Physical, and Social Science Technicians"
17,Illinois,195,2448,2119,329,24,0,141,124,114,10,1,0,4,19-5000,Occupational Health and Safety Specialists and Technicians
17,Illinois,211,76367,70048,6319,210,414,1439,4167,3872,295,14,21,67,21-1000,"Counselors, Social Workers, and Other Community and Social Service Specialists"
17,Illinois,212,19591,16429,3162,50,282,333,1307,1115,192,4,23,34,21-2000,Religious Workers
17,Illinois,231,50180,46751,3429,14,102,53,2670,2503,167,1,3,2,23-1000,"Lawyers, Judges, and Related Workers"
17,Illinois,232,18435,16832,1603,96,75,411,1013,918,95,6,6,20,23-2000,Legal Support Workers
17,Illinois,251,55051,40055,14996,219,810,483,3146,2358,788,9,44,28,25-1000,Postsecondary Teachers
17,Illinois,252,206711,193533,13178,456,1182,2776,12432,11736,696,18,49,134,25-2000,"Preschool, Elementary, Middle, Secondary, and Special Education Teachers"
17,Illinois,253,32823,29470,3353,62,277,271,2023,1813,210,4,18,16,25-3000,Other Teachers and Instructors
17,Illinois,254,11524,10834,690,0,29,149,716,672,44,0,3,6,25-4000,"Librarians, Curators, and Archivists"
17,Illinois,259,48960,42560,6400,114,274,1895,3172,2792,380,8,13,109,25-9000,Other Educational Instruction and Library Occupations
17,Illinois,271,39157,34784,4373,102,261,891,2255,2027,228,3,15,37,27-1000,Art and Design Workers
17,Illinois,272,27079,24740,2339,62,154,513,1748,1624,124,3,12,14,27-2000,"Entertainers and Performers, Sports and Related Workers"
17,Illinois,273,32236,29349,2887,161,245,470,1834,1662,172,9,12,29,27-3000,Media and Communication Workers
17,Illinois,274,11880,10525,1355,0,36,283,697,638,59,0,1,8,27-4000,Media and Communication Equipment Workers
17,Illinois,291,246189,199488,46701,549,1107,1523,13278,11175,2103,20,52,71,29-1000,Healthcare Diagnosing or Treating Practitioners
17,Illinois,292,99201,86035,13166,115,389,1649,5566,4957,609,8,17,71,29-2000,Health Technologists and Technicians
17,Illinois,299,3194,2729,465,0,0,0,174,154,20,0,0,0,29-9000,Other Healthcare Practitioners and Technical Occupations
17,Illinois,3111,130634,105580,25054,750,487,4640,6876,5795,1081,29,25,201,31-1100,"Home Health and Personal Care Aides; and Nursing Assistants, Orderlies, and Psychiatric Aides"
17,Illinois,312,6420,5465,955,0,47,55,397,358,39,0,1,2,31-2000,Occupational Therapy and Physical Therapist Assistants and Aides
17,Illinois,319,52251,44178,8073,242,255,2289,2681,2316,365,11,10,90,31-9000,Other Healthcare Support Occupations
17,Illinois,331,10772,10067,705,0,124,273,674,655,19,0,2,7,33-1000,Supervisors of Protective Service Workers
17,Illinois,332,13905,13561,344,0,15,68,718,701,17,0,1,3,33-2000,Firefighting and Prevention Workers
17,Illinois,333,51586,49006,2580,146,142,607,2797,2684,113,7,4,29,33-3000,Law Enforcement Workers
17,Illinois,339,52847,49525,3322,112,128,1192,3127,2964,163,8,7,48,33-9000,Other Protective Service Workers
17,Illinois,351,39405,28856,10549,109,435,6539,1833,1434,399,9,15,201,35-1000,Supervisors of Food Preparation and Serving Workers
17,Illinois,352,127161,86670,40491,1715,1828,29297,7036,5601,1435,58,66,913,35-2000,Cooks and Food Preparation Workers
17,Illinois,353,130385,109476,20909,839,928,11132,7239,6311,928,32,43,425,35-3000,Food and Beverage Serving Workers
17,Illinois,359,38594,27437,11157,426,642,7411,2331,1944,387,15,20,230,35-9000,Other Food Preparation and Serving Related Workers
17,Illinois,371,12564,8977,3587,328,19,2031,635,504,131,8,1,73,37-1000,Supervisors of Building and Grounds Cleaning and Maintenance Workers
17,Illinois,372,146989,93231,53758,3399,2001,30467,8412,6287,2125,142,79,1128,37-2000,Building Cleaning and Pest Control Workers
17,Illinois,373,41985,25205,16780,366,92,15499,2550,1969,581,15,6,522,37-3000,Grounds Maintenance Workers
17,Illinois,391,3935,3240,695,0,74,28,205,177,28,0,1,3,39-1000,Supervisors of Personal Care and Service Workers
17,Illinois,392,11601,10928,673,53,8,272,749,705,44,2,2,13,39-2000,Animal Care and Service Workers
17,Illinois,393,11866,11344,522,28,0,218,829,784,45,2,0,13,39-3000,Entertainment Attendants and Related Workers
17,Illinois,394,1635,1635,0,0,0,0,104,104,0,0,0,0,39-4000,Funeral Service Workers
17,Illinois,395,49985,35583,14402,350,334,2165,2466,1874,592,14,14,92,39-5000,Personal Appearance Workers
17,Illinois,396,4453,3642,811,45,18,342,186,148,38,2,2,13,39-6000,"Baggage Porters, Bellhops, and Concierges"
17,Illinois,397,1470,1313,157,27,0,22,119,109,10,1,0,1,39-7000,Tour and Travel Guides
17,Illinois,399,84500,71034,13466,1164,1280,4504,5567,4918,649,44,53,200,39-9000,Other Personal Care and Service Workers
17,Illinois,411,157404,136825,20579,344,556,6120,8439,7556,883,15,31,227,41-1000,Supervisors of Sales Workers
17,Illinois,412,252091,218544,33547,774,1130,12536,14863,13221,1642,39,60,506,41-2000,Retail Sales Workers
17,Illinois,413,80054,73040,7014,68,324,1590,4251,3900,351,4,18,67,41-3000,"Sales Representatives, Services"
17,Illinois,414,60665,55120,5545,150,407,1346,3210,2966,244,7,13,57,41-4000,"Sales Representatives, Wholesale and Manufacturing"
17,Illinois,419,47657,41014,6643,64,248,1990,2594,2275,319,5,12,73,41-9000,Other Sales and Related Workers
17,Illinois,431,48796,42908,5888,325,278,1843,2776,2509,267,10,9,79,43-1000,Supervisors of Office and Administrative Support Workers
17,Illinois,432,2333,2224,109,0,12,28,142,130,12,1,1,3,43-2000,Communications Equipment Operators
17,Illinois,433,89337,78672,10665,478,433,3013,5421,4904,517,22,25,123,43-3000,Financial Clerks
17,Illinois,434,210707,187576,23131,741,1297,7726,11654,10571,1083,31,55,322,43-4000,Information and Record Clerks
17,Illinois,435,92953,76739,16214,513,816,7434,5051,4420,631,21,32,253,43-5000,"Material Recording, Scheduling, Dispatching, and Distributing Workers"
17,Illinois,436,113804,103113,10691,402,454,3727,7365,6791,574,20,23,167,43-6000,Secretaries and Administrative Assistants
17,Illinois,439,117612,103197,14415,745,578,4249,7087,6362,725,33,25,185,43-9000,Other Office and Administrative Support Workers
17,Illinois,451,1077,867,210,0,0,210,76,69,7,0,0,7,45-1000,"Supervisors of Farming, Fishing, and Forestry Workers"
17,Illinois,452,15637,13338,2299,92,0,2053,1530,1386,144,13,0,112,45-2000,Agricultural Workers
17,Illinois,453,35,35,0,0,0,0,9,9,0,0,0,0,45-3000,Fishing and Hunting Workers
17,Illinois,454,942,796,146,0,0,122,81,73,8,0,0,4,45-4000,"Forest, Conservation, and Logging Workers"
17,Illinois,471,18803,15710,3093,213,102,1640,1108,976,132,6,6,60,47-1000,Supervisors of Construction and Extraction Workers
17,Illinois,472,220172,155189,64983,2955,1544,41321,12451,10155,2296,88,52,1330,47-2000,Construction Trades Workers
17,Illinois,473,557,443,114,0,0,77,41,37,4,0,0,3,47-3000,"Helpers, Construction Trades"
17,Illinois,474,11657,10347,1310,44,38,853,761,708,53,1,1,35,47-4000,Other Construction and Related Workers
17,Illinois,475,4276,4139,137,0,0,109,355,349,6,0,0,4,47-5000,Extraction Workers
17,Illinois,491,8302,7383,919,0,0,400,495,453,42,0,0,18,49-1000,"Supervisors of Installation, Maintenance, and Repair Workers"
17,Illinois,492,16797,13842,2955,47,19,1624,899,783,116,2,2,50,49-2000,"Electrical and Electronic Equipment Mechanics, Installers, and Repairers"
17,Illinois,493,65778,52506,13272,614,402,8076,3654,3180,474,24,14,265,49-3000,"Vehicle and Mobile Equipment Mechanics, Installers, and Repairers"
17,Illinois,499,74774,62440,12334,461,220,7021,4376,3873,503,17,11,266,49-9000,"Other Installation, Maintenance, and Repair Occupations"
17,Illinois,511,38551,29426,9125,337,220,5592,2158,1769,389,14,10,227,51-1000,Supervisors of Production Workers
17,Illinois,512,54172,36250,17922,573,515,12337,3061,2340,721,22,19,455,51-2000,Assemblers and Fabricators
17,Illinois,513,34383,20205,14178,871,155,10383,1698,1209,489,26,10,331,51-3000,Food Processing Workers
17,Illinois,514,77807,53913,23894,1136,351,15814,4523,3581,942,43,14,586,51-4000,Metal Workers and Plastic Workers
17,Illinois,5151,11185,9159,2026,125,70,1125,652,559,93,3,7,49,51-5100,Printing Workers
17,Illinois,516,15482,7637,7845,154,354,4800,845,520,325,11,15,176,51-6000,"Textile, Apparel, and Furnishings Workers"
17,Illinois,517,3397,2760,637,0,36,430,217,187,30,0,2,18,51-7000,Woodworkers
17,Illinois,518,12073,10844,1229,105,111,313,754,705,49,3,4,12,51-8000,Plant and System Operators
17,Illinois,519,138679,92351,46328,2117,1101,30971,7935,6096,1839,76,39,1147,51-9000,Other Production Occupations
17,Illinois,531,10178,8830,1348,18,104,646,568,513,55,2,4,24,53-1000,Supervisors of Transportation and Material Moving Workers
17,Illinois,532,12291,10818,1473,27,151,115,553,497,56,2,6,3,53-2000,Air Transportation Workers
17,Illinois,533,200344,148412,51932,1507,1722,16117,10595,8697,1898,51,63,570,53-3000,Motor Vehicle Operators
17,Illinois,534,8544,8125,419,52,0,219,426,409,17,1,0,6,53-4000,Rail Transportation Workers
17,Illinois,535,1658,1547,111,0,0,0,117,111,6,0,0,0,53-5000,Water Transportation Workers
17,Illinois,536,11440,9315,2125,28,78,827,625,533,92,1,4,30,53-6000,Other Transportation Workers
17,Illinois,537,263191,202438,60753,2938,1280,43925,15102,12695,2407,112,62,1646,53-7000,Material Moving Workers
18,Indiana,111,39644,37688,1956,0,48,309,1965,1889,76,0,4,9,11-1000,Top Executives
18,Indiana,112,18732,18144,588,21,47,47,947,915,32,2,2,2,11-2000,"Advertising, Marketing, Promotions, Public Relations, and Sales Managers"
18,Indiana,113,55358,52339,3019,192,24,365,2926,2812,114,5,1,13,11-3000,Operations Specialties Managers
18,Indiana,119,164001,155269,8732,275,386,1953,8687,8340,347,9,21,58,11-9000,Other Management Occupations
18,Indiana,131,74869,71627,3242,20,322,576,4072,3910,162,1,12,25,13-1000,Business Operations Specialists
18,Indiana,132,56931,54745,2186,0,78,227,2911,2796,115,0,6,13,13-2000,Financial Specialists
18,Indiana,1512,61698,53907,7791,55,180,320,3099,2815,284,2,8,11,15-1200,Computer Occupations
18,Indiana,152,3415,3138,277,0,0,0,183,169,14,0,0,0,15-2000,Mathematical Science Occupations
18,Indiana,171,2542,2443,99,0,0,0,132,130,2,0,0,0,17-1000,"Architects, Surveyors, and Cartographers"
18,Indiana,172,44025,38631,5394,54,190,358,2220,2028,192,3,10,17,17-2000,Engineers
18,Indiana,173,13923,13421,502,41,0,43,855,834,21,1,0,3,17-3000,"Drafters, Engineering Technicians, and Mapping Technicians"
18,Indiana,191,4421,3217,1204,0,51,27,212,162,50,1,2,1,19-1000,Life Scientists
18,Indiana,192,6620,4802,1818,0,75,38,370,288,82,0,2,2,19-2000,Physical Scientists
18,Indiana,193,2528,2330,198,0,19,0,149,140,9,0,1,0,19-3000,Social Scientists and Related Workers
18,Indiana,194,7216,6506,710,0,0,47,475,443,32,0,0,4,19-4000,"Life, Physical, and Social Science Technicians"
18,Indiana,195,1089,1070,19,0,0,0,61,60,1,0,0,0,19-5000,Occupational Health and Safety Specialists and Technicians
18,Indiana,211,35665,34454,1211,24,125,248,1948,1887,61,3,5,10,21-1000,"Counselors, Social Workers, and Other Community and Social Service Specialists"
18,Indiana,212,12687,12051,636,58,20,244,746,704,42,6,1,16,21-2000,Religious Workers
18,Indiana,231,13863,13650,213,9,17,58,687,670,17,2,2,2,23-1000,"Lawyers, Judges, and Related Workers"
18,Indiana,232,7628,7486,142,9,30,27,443,424,19,1,2,2,23-2000,Legal Support Workers
18,Indiana,251,31481,23230,8251,78,382,42,1763,1348,415,8,20,4,25-1000,Postsecondary Teachers
18,Indiana,252,94063,91757,2306,120,110,395,5524,5404,120,4,9,21,25-2000,"Preschool, Elementary, Middle, Secondary, and Special Education Teachers"
18,Indiana,253,12982,12133,849,16,33,209,904,844,60,3,3,9,25-3000,Other Teachers and Instructors
18,Indiana,254,5069,4932,137,0,32,0,347,336,11,0,1,0,25-4000,"Librarians, Curators, and Archivists"
18,Indiana,259,23845,22082,1763,40,61,263,1638,1526,112,7,3,21,25-9000,Other Educational Instruction and Library Occupations
18,Indiana,271,15767,14632,1135,170,41,419,887,846,41,4,4,5,27-1000,Art and Design Workers
18,Indiana,272,9162,8662,500,0,20,34,657,625,32,0,1,4,27-2000,"Entertainers and Performers, Sports and Related Workers"
18,Indiana,273,11739,10798,941,24,14,233,655,609,46,2,2,9,27-3000,Media and Communication Workers
18,Indiana,274,5045,4914,131,0,0,38,317,301,16,0,5,1,27-4000,Media and Communication Equipment Workers
18,Indiana,291,127410,118424,8986,45,262,467,6605,6237,368,3,11,21,29-1000,Healthcare Diagnosing or Treating Practitioners
18,Indiana,292,58924,56897,2027,0,83,219,3212,3123,89,0,2,12,29-2000,Health Technologists and Technicians
18,Indiana,299,1625,1583,42,21,0,0,87,85,2,1,0,0,29-9000,Other Healthcare Practitioners and Technical Occupations
18,Indiana,3111,58499,55803,2696,20,208,263,3332,3218,114,1,4,13,31-1100,"Home Health and Personal Care Aides; and Nursing Assistants, Orderlies, and Psychiatric Aides"
18,Indiana,312,2993,2970,23,0,0,23,184,183,1,0,0,1,31-2000,Occupational Therapy and Physical Therapist Assistants and Aides
18,Indiana,319,27768,26553,1215,63,83,250,1501,1444,57,5,4,14,31-9000,Other Healthcare Support Occupations
18,Indiana,331,4884,4847,37,0,0,0,283,281,2,0,0,0,33-1000,Supervisors of Protective Service Workers
18,Indiana,332,7327,7296,31,0,0,23,377,374,3,0,0,1,33-2000,Firefighting and Prevention Workers
18,Indiana,333,23389,23078,311,35,39,61,1221,1209,12,1,1,3,33-3000,Law Enforcement Workers
18,Indiana,339,16061,15492,569,43,40,104,1165,1132,33,2,1,7,33-9000,Other Protective Service Workers
18,Indiana,351,18716,17157,1559,24,0,837,978,916,62,2,0,24,35-1000,Supervisors of Food Preparation and Serving Workers
18,Indiana,352,70616,63306,7310,520,102,3809,4441,4133,308,13,8,146,35-2000,Cooks and Food Preparation Workers
18,Indiana,353,71427,67063,4364,191,201,1900,4233,4025,208,8,8,68,35-3000,Food and Beverage Serving Workers
18,Indiana,359,21361,19779,1582,181,38,938,1383,1290,93,6,2,42,35-9000,Other Food Preparation and Serving Related Workers
18,Indiana,371,7942,7607,335,0,13,273,410,392,18,0,1,13,37-1000,Supervisors of Building and Grounds Cleaning and Maintenance Workers
18,Indiana,372,72601,66261,6340,613,240,3610,4780,4468,312,26,16,161,37-2000,Building Cleaning and Pest Control Workers
18,Indiana,373,22823,19623,3200,238,252,2487,1599,1469,130,9,7,89,37-3000,Grounds Maintenance Workers
18,Indiana,391,1667,1577,90,0,0,11,88,82,6,0,0,1,39-1000,Supervisors of Personal Care and Service Workers
18,Indiana,392,5448,5193,255,79,26,90,350,339,11,2,1,3,39-2000,Animal Care and Service Workers
18,Indiana,393,5310,5070,240,0,45,0,410,396,14,0,1,1,39-3000,Entertainment Attendants and Related Workers
18,Indiana,394,1345,1300,45,0,0,0,72,70,2,0,0,0,39-4000,Funeral Service Workers
18,Indiana,395,22197,19213,2984,53,0,171,1111,994,117,2,0,12,39-5000,Personal Appearance Workers
18,Indiana,396,320,320,0,0,0,0,21,21,0,0,0,0,39-6000,"Baggage Porters, Bellhops, and Concierges"
18,Indiana,397,713,702,11,0,0,0,67,65,2,0,0,0,39-7000,Tour and Travel Guides
18,Indiana,399,35948,33965,1983,127,106,318,2380,2278,102,7,4,19,39-9000,Other Personal Care and Service Workers
18,Indiana,411,81493,78174,3319,119,114,910,4282,4151,131,6,7,34,41-1000,Supervisors of Sales Workers
18,Indiana,412,120557,115823,4734,99,125,1463,7926,7644,282,10,11,68,41-2000,Retail Sales Workers
18,Indiana,413,26004,25281,723,9,29,128,1388,1356,32,1,3,6,41-3000,"Sales Representatives, Services"
18,Indiana,414,29251,28109,1142,118,165,357,1509,1462,47,4,4,11,41-4000,"Sales Representatives, Wholesale and Manufacturing"
18,Indiana,419,22280,21444,836,87,0,111,1188,1145,43,4,0,7,41-9000,Other Sales and Related Workers
18,Indiana,431,21509,20850,659,16,37,182,1218,1183,35,1,2,10,43-1000,Supervisors of Office and Administrative Support Workers
18,Indiana,432,964,964,0,0,0,0,80,79,1,0,0,0,43-2000,Communications Equipment Operators
18,Indiana,433,46981,45294,1687,50,136,473,2762,2686,76,4,4,13,43-3000,Financial Clerks
18,Indiana,434,102303,98053,4250,293,121,1051,5906,5705,201,8,11,46,43-4000,Information and Record Clerks
18,Indiana,435,50949,48233,2716,279,79,894,2925,2819,106,8,2,34,43-5000,"Material Recording, Scheduling, Dispatching, and Distributing Workers"
18,Indiana,436,60018,58661,1357,121,72,340,3745,3658,87,6,9,24,43-6000,Secretaries and Administrative Assistants
18,Indiana,439,54382,52340,2042,121,75,455,3397,3277,120,5,5,19,43-9000,Other Office and Administrative Support Workers
18,Indiana,451,630,630,0,0,0,0,47,47,0,0,0,0,45-1000,"Supervisors of Farming, Fishing, and Forestry Workers"
18,Indiana,452,11650,10250,1400,364,25,767,830,769,61,10,2,38,45-2000,Agricultural Workers
18,Indiana,453,59,59,0,0,0,0,6,6,0,0,0,0,45-3000,Fishing and Hunting Workers
18,Indiana,454,1176,1050,126,19,0,107,71,67,4,1,0,3,45-4000,"Forest, Conservation, and Logging Workers"
18,Indiana,471,14048,13312,736,72,21,458,745,719,26,2,1,17,47-1000,Supervisors of Construction and Extraction Workers
18,Indiana,472,127577,113197,14380,2655,236,10219,7170,6687,483,85,6,326,47-2000,Construction Trades Workers
18,Indiana,473,289,289,0,0,0,0,28,28,0,0,0,0,47-3000,"Helpers, Construction Trades"
18,Indiana,474,6180,5863,317,33,0,171,337,328,9,1,0,5,47-4000,Other Construction and Related Workers
18,Indiana,475,3221,3168,53,0,0,47,200,197,3,0,0,2,47-5000,Extraction Workers
18,Indiana,491,5520,5352,168,0,0,143,331,326,5,0,0,3,49-1000,"Supervisors of Installation, Maintenance, and Repair Workers"
18,Indiana,492,9493,9167,326,0,13,0,544,527,17,0,1,0,49-2000,"Electrical and Electronic Equipment Mechanics, Installers, and Repairers"
18,Indiana,493,39622,37925,1697,213,15,837,2128,2070,58,7,2,28,49-3000,"Vehicle and Mobile Equipment Mechanics, Installers, and Repairers"
18,Indiana,499,54878,53011,1867,202,117,1016,3148,3073,75,6,2,38,49-9000,"Other Installation, Maintenance, and Repair Occupations"
18,Indiana,511,35227,32733,2494,158,94,1703,1993,1901,92,7,4,54,51-1000,Supervisors of Production Workers
18,Indiana,512,64915,58523,6392,473,192,3670,3728,3479,249,22,11,131,51-2000,Assemblers and Fabricators
18,Indiana,513,14159,11792,2367,285,36,1291,858,766,92,15,4,41,51-3000,Food Processing Workers
18,Indiana,514,72048,66659,5389,322,92,2968,4210,4010,200,12,4,120,51-4000,Metal Workers and Plastic Workers
18,Indiana,5151,5735,5318,417,73,0,141,365,347,18,2,0,6,51-5100,Printing Workers
18,Indiana,516,10029,8102,1927,179,19,1228,605,519,86,10,1,45,51-6000,"Textile, Apparel, and Furnishings Workers"
18,Indiana,517,6211,5750,461,123,87,204,371,352,19,4,1,9,51-7000,Woodworkers
18,Indiana,518,5252,5128,124,0,0,0,339,331,8,0,0,0,51-8000,Plant and System Operators
18,Indiana,519,110937,99948,10989,1082,279,5491,6734,6275,459,42,17,228,51-9000,Other Production Occupations
18,Indiana,531,6332,6064,268,25,0,74,309,294,15,2,0,3,53-1000,Supervisors of Transportation and Material Moving Workers
18,Indiana,532,4074,3929,145,11,0,0,193,186,7,1,0,0,53-2000,Air Transportation Workers
18,Indiana,533,92971,88015,4956,362,90,1113,5287,5106,181,14,6,45,53-3000,Motor Vehicle Operators
18,Indiana,534,4170,4118,52,19,0,27,249,245,4,1,0,2,53-4000,Rail Transportation Workers
18,Indiana,535,457,457,0,0,0,0,34,34,0,0,0,0,53-5000,Water Transportation Workers
18,Indiana,536,5092,4687,405,41,12,15,269,263,6,1,1,1,53-6000,Other Transportation Workers
18,Indiana,537,165481,149642,15839,1693,631,7724,9781,9206,575,54,24,277,53-7000,Material Moving Workers
19,Iowa,111,18040,17538,502,0,0,179,845,829,16,0,0,4,11-1000,Top Executives
19,Iowa,112,8029,7788,241,0,0,0,387,377,10,0,0,0,11-2000,"Advertising, Marketing, Promotions, Public Relations, and Sales Managers"
19,Iowa,113,29250,28266,984,107,0,153,1372,1342,30,3,0,4,11-3000,Operations Specialties Managers
19,Iowa,119,98359,92933,5426,417,56,1176,5264,5096,168,8,1,44,11-9000,Other Management Occupations
19,Iowa,131,39717,38109,1608,60,105,132,1911,1862,49,4,5,8,13-1000,Business Operations Specialists
19,Iowa,132,34937,33989,948,0,0,85,1676,1640,36,0,0,3,13-2000,Financial Specialists
19,Iowa,1512,37033,31951,5082,53,36,133,1659,1528,131,2,4,3,15-1200,Computer Occupations
19,Iowa,152,2306,1962,344,0,0,0,92,84,8,0,0,0,15-2000,Mathematical Science Occupations
19,Iowa,171,1338,1325,13,0,0,0,63,61,2,0,0,0,17-1000,"Architects, Surveyors, and Cartographers"
19,Iowa,172,15978,14757,1221,0,51,62,737,700,37,0,1,3,17-2000,Engineers
19,Iowa,173,6890,6608,282,64,0,14,412,400,12,1,0,1,17-3000,"Drafters, Engineering Technicians, and Mapping Technicians"
19,Iowa,191,3277,2834,443,0,143,0,141,131,10,0,2,0,19-1000,Life Scientists
19,Iowa,192,3172,2657,515,0,20,0,147,120,27,0,1,0,19-2000,Physical Scientists
19,Iowa,193,1552,1314,238,0,0,0,66,62,4,0,0,0,19-3000,Social Scientists and Related Workers
19,Iowa,194,5598,5330,268,40,25,24,311,298,13,1,1,2,19-4000,"Life, Physical, and Social Science Technicians"
19,Iowa,195,880,778,102,0,0,39,51,47,4,0,0,1,19-5000,Occupational Health and Safety Specialists and Technicians
19,Iowa,211,20023,19575,448,29,38,147,1006,987,19,1,1,5,21-1000,"Counselors, Social Workers, and Other Community and Social Service Specialists"
19,Iowa,212,5539,5093,446,30,26,3,357,335,22,1,1,1,21-2000,Religious Workers
19,Iowa,231,6082,5996,86,0,0,5,259,256,3,0,0,1,23-1000,"Lawyers, Judges, and Related Workers"
19,Iowa,232,3475,3366,109,12,0,13,186,181,5,1,0,1,23-2000,Legal Support Workers
19,Iowa,251,16218,13161,3057,2,141,146,700,599,101,1,6,4,25-1000,Postsecondary Teachers
19,Iowa,252,54755,53590,1165,0,41,323,3081,3034,47,0,2,8,25-2000,"Preschool, Elementary, Middle, Secondary, and Special Education Teachers"
19,Iowa,253,5918,5587,331,0,82,0,356,340,16,0,2,0,25-3000,Other Teachers and Instructors
19,Iowa,254,2823,2792,31,0,29,0,167,163,4,0,1,0,25-4000,"Librarians, Curators, and Archivists"
19,Iowa,259,17103,16096,1007,15,0,144,1083,1036,47,3,2,8,25-9000,Other Educational Instruction and Library Occupations
19,Iowa,271,8169,7894,275,0,0,23,437,425,12,1,0,3,27-1000,Art and Design Workers
19,Iowa,272,4782,4434,348,0,0,39,304,290,14,0,1,1,27-2000,"Entertainers and Performers, Sports and Related Workers"
19,Iowa,273,6290,5869,421,73,15,84,303,285,18,2,1,5,27-3000,Media and Communication Workers
19,Iowa,274,2374,2237,137,0,57,0,132,127,5,0,2,0,27-4000,Media and Communication Equipment Workers
19,Iowa,291,63861,60112,3749,36,175,201,3308,3195,113,2,8,4,29-1000,Healthcare Diagnosing or Treating Practitioners
19,Iowa,292,26310,25277,1033,0,22,89,1475,1435,40,0,2,5,29-2000,Health Technologists and Technicians
19,Iowa,299,624,551,73,0,0,0,40,37,3,0,0,0,29-9000,Other Healthcare Practitioners and Technical Occupations
19,Iowa,3111,33039,30996,2043,22,38,351,1968,1896,72,4,2,11,31-1100,"Home Health and Personal Care Aides; and Nursing Assistants, Orderlies, and Psychiatric Aides"
19,Iowa,312,1160,1160,0,0,0,0,80,80,0,0,0,0,31-2000,Occupational Therapy and Physical Therapist Assistants and Aides
19,Iowa,319,12657,12066,591,0,127,84,720,703,17,0,2,4,31-9000,Other Healthcare Support Occupations
19,Iowa,331,1574,1529,45,0,0,0,102,100,2,0,0,0,33-1000,Supervisors of Protective Service Workers
19,Iowa,332,1724,1724,0,0,0,0,88,88,0,0,0,0,33-2000,Firefighting and Prevention Workers
19,Iowa,333,9189,9093,96,0,0,4,507,499,8,0,0,1,33-3000,Law Enforcement Workers
19,Iowa,339,8002,7845,157,5,6,8,599,587,12,1,1,1,33-9000,Other Protective Service Workers
19,Iowa,351,8757,8364,393,0,0,86,455,437,18,0,1,5,35-1000,Supervisors of Food Preparation and Serving Workers
19,Iowa,352,36040,32273,3767,441,42,1543,2314,2177,137,12,2,41,35-2000,Cooks and Food Preparation Workers
19,Iowa,353,30561,28247,2314,135,0,904,1600,1511,89,4,1,25,35-3000,Food and Beverage Serving Workers
19,Iowa,359,8618,8076,542,17,17,300,500,473,27,1,3,9,35-9000,Other Food Preparation and Serving Related Workers
19,Iowa,371,3211,2764,447,76,0,166,178,168,10,2,0,4,37-1000,Supervisors of Building and Grounds Cleaning and Maintenance Workers
19,Iowa,372,33834,29049,4785,304,57,2222,2222,2061,161,13,4,59,37-2000,Building Cleaning and Pest Control Workers
19,Iowa,373,9146,8756,390,144,7,173,731,711,20,2,2,11,37-3000,Grounds Maintenance Workers
19,Iowa,391,893,893,0,0,0,0,41,41,0,0,0,0,39-1000,Supervisors of Personal Care and Service Workers
19,Iowa,392,2664,2559,105,0,0,97,174,170,4,0,0,3,39-2000,Animal Care and Service Workers
19,Iowa,393,3004,2893,111,31,16,0,204,198,6,1,1,0,39-3000,Entertainment Attendants and Related Workers
19,Iowa,394,671,671,0,0,0,0,40,40,0,0,0,0,39-4000,Funeral Service Workers
19,Iowa,395,10139,9075,1064,74,0,43,528,492,36,1,0,1,39-5000,Personal Appearance Workers
19,Iowa,396,244,134,110,0,0,0,7,6,1,0,0,0,39-6000,"Baggage Porters, Bellhops, and Concierges"
19,Iowa,397,564,439,125,0,90,0,31,29,2,0,1,0,39-7000,Tour and Travel Guides
19,Iowa,399,26127,24981,1146,61,47,459,1712,1652,60,2,3,18,39-9000,Other Personal Care and Service Workers
19,Iowa,411,42422,40525,1897,83,0,402,2214,2171,43,2,0,10,41-1000,Supervisors of Sales Workers
19,Iowa,412,61403,59180,2223,77,59,597,3830,3722,108,7,2,19,41-2000,Retail Sales Workers
19,Iowa,413,14908,14325,583,0,27,84,751,734,17,0,1,5,41-3000,"Sales Representatives, Services"
19,Iowa,414,13219,12968,251,0,0,2,649,641,8,0,0,1,41-4000,"Sales Representatives, Wholesale and Manufacturing"
19,Iowa,419,9665,9411,254,0,0,51,491,482,9,0,0,2,41-9000,Other Sales and Related Workers
19,Iowa,431,10810,10532,278,0,0,65,568,556,12,0,0,2,43-1000,Supervisors of Office and Administrative Support Workers
19,Iowa,432,399,399,0,0,0,0,24,23,1,0,0,0,43-2000,Communications Equipment Operators
19,Iowa,433,25402,24390,1012,0,16,205,1504,1470,34,4,1,5,43-3000,Financial Clerks
19,Iowa,434,50979,49328,1651,73,9,434,2886,2800,86,8,3,18,43-4000,Information and Record Clerks
19,Iowa,435,22059,21076,983,8,0,209,1301,1269,32,2,0,6,43-5000,"Material Recording, Scheduling, Dispatching, and Distributing Workers"
19,Iowa,436,33019,32566,453,40,0,72,2026,2002,24,2,0,5,43-6000,Secretaries and Administrative Assistants
19,Iowa,439,30401,29492,909,0,3,132,1790,1752,38,0,1,4,43-9000,Other Office and Administrative Support Workers
19,Iowa,451,765,633,132,45,0,87,57,51,6,2,0,4,45-1000,"Supervisors of Farming, Fishing, and Forestry Workers"
19,Iowa,452,15721,12883,2838,801,75,1565,1308,1195,113,28,1,70,45-2000,Agricultural Workers
19,Iowa,453,17,17,0,0,0,0,3,3,0,0,0,0,45-3000,Fishing and Hunting Workers
19,Iowa,454,309,256,53,0,0,0,28,27,1,0,0,0,45-4000,"Forest, Conservation, and Logging Workers"
19,Iowa,471,7825,7531,294,29,0,184,453,443,10,1,0,5,47-1000,Supervisors of Construction and Extraction Workers
19,Iowa,472,62535,57203,5332,692,0,4029,3745,3588,157,23,1,107,47-2000,Construction Trades Workers
19,Iowa,473,377,377,0,0,0,0,23,22,1,0,0,1,47-3000,"Helpers, Construction Trades"
19,Iowa,474,4162,3987,175,0,31,98,238,231,7,0,1,4,47-4000,Other Construction and Related Workers
19,Iowa,475,729,729,0,0,0,0,57,57,0,0,0,0,47-5000,Extraction Workers
19,Iowa,491,2822,2807,15,0,0,0,170,169,1,0,0,0,49-1000,"Supervisors of Installation, Maintenance, and Repair Workers"
19,Iowa,492,4884,4803,81,0,0,0,254,249,5,0,0,0,49-2000,"Electrical and Electronic Equipment Mechanics, Installers, and Repairers"
19,Iowa,493,20230,19616,614,138,0,141,1249,1235,14,3,0,5,49-3000,"Vehicle and Mobile Equipment Mechanics, Installers, and Repairers"
19,Iowa,499,24797,23712,1085,71,0,354,1476,1436,40,2,0,13,49-9000,"Other Installation, Maintenance, and Repair Occupations"
19,Iowa,511,13330,12447,883,121,0,450,762,727,35,4,0,18,51-1000,Supervisors of Production Workers
19,Iowa,512,18568,16463,2105,263,0,333,1081,1020,61,8,0,17,51-2000,Assemblers and Fabricators
19,Iowa,513,14597,7649,6948,783,310,2603,638,455,183,26,2,70,51-3000,Food Processing Workers
19,Iowa,514,25031,23377,1654,46,0,914,1670,1624,46,4,0,19,51-4000,Metal Workers and Plastic Workers
19,Iowa,5151,2589,2474,115,0,0,0,165,161,4,0,0,0,51-5100,Printing Workers
19,Iowa,516,4240,3750,490,15,0,170,235,218,17,1,0,4,51-6000,"Textile, Apparel, and Furnishings Workers"
19,Iowa,517,1781,1420,361,0,0,17,123,115,8,0,0,2,51-7000,Woodworkers
19,Iowa,518,2876,2756,120,0,0,0,182,179,3,0,0,0,51-8000,Plant and System Operators
19,Iowa,519,48494,39444,9050,878,76,3180,2623,2369,254,22,2,96,51-9000,Other Production Occupations
19,Iowa,531,2041,2041,0,0,0,0,138,137,1,0,0,0,53-1000,Supervisors of Transportation and Material Moving Workers
19,Iowa,532,1010,992,18,0,0,0,56,54,2,0,0,0,53-2000,Air Transportation Workers
19,Iowa,533,46903,44810,2093,197,0,652,2968,2882,86,8,0,25,53-3000,Motor Vehicle Operators
19,Iowa,534,1525,1525,0,0,0,0,111,111,0,0,0,0,53-4000,Rail Transportation Workers
19,Iowa,535,85,38,47,0,0,47,7,5,2,0,0,1,53-5000,Water Transportation Workers
19,Iowa,536,2053,1791,262,0,92,0,131,128,3,0,1,0,53-6000,Other Transportation Workers
19,Iowa,537,76216,68839,7377,770,13,2762,4481,4218,263,27,3,93,53-7000,Material Moving Workers
20,Kansas,111,18190,17646,544,0,24,190,923,901,22,0,1,6,11-1000,Top Executives
20,Kansas,112,8933,8448,485,0,97,25,426,406,20,0,4,2,11-2000,"Advertising, Marketing, Promotions, Public Relations, and Sales Managers"
20,Kansas,113,24619,23349,1270,70,14,265,1269,1211,58,3,1,14,11-3000,Operations Specialties Managers
20,Kansas,119,85756,80125,5631,206,194,1616,4798,4607,191,8,9,62,11-9000,Other Management Occupations
20,Kansas,131,37188,35580,1608,103,16,569,1797,1725,72,2,1,18,13-1000,Business Operations Specialists
20,Kansas,132,31333,29374,1959,33,112,466,1528,1451,77,1,6,16,13-2000,Financial Specialists
20,Kansas,1512,38721,33115,5606,0,123,369,1788,1556,232,0,7,14,15-1200,Computer Occupations
20,Kansas,152,2025,1721,304,0,0,0,94,83,11,0,0,0,15-2000,Mathematical Science Occupations
20,Kansas,171,1727,1535,192,51,0,0,78,72,6,1,0,0,17-1000,"Architects, Surveyors, and Cartographers"
20,Kansas,172,19051,16374,2677,0,145,293,879,774,105,0,6,13,17-2000,Engineers
20,Kansas,173,6594,6274,320,2,0,0,344,332,12,1,0,0,17-3000,"Drafters, Engineering Technicians, and Mapping Technicians"
20,Kansas,191,1898,1368,530,0,0,9,102,86,16,0,0,1,19-1000,Life Scientists
20,Kansas,192,2801,2292,509,0,0,0,122,103,19,0,0,0,19-2000,Physical Scientists
20,Kansas,193,1533,1481,52,0,12,6,84,81,3,0,1,1,19-3000,Social Scientists and Related Workers
20,Kansas,194,3391,3054,337,0,0,77,169,158,11,0,1,2,19-4000,"Life, Physical, and Social Science Technicians"
20,Kansas,195,550,550,0,0,0,0,31,31,0,0,0,0,19-5000,Occupational Health and Safety Specialists and Technicians
20,Kansas,211,17024,16565,459,61,7,206,921,895,26,3,1,12,21-1000,"Counselors, Social Workers, and Other Community and Social Service Specialists"
20,Kansas,212,5093,4608,485,135,0,72,326,301,25,5,0,4,21-2000,Religious Workers
20,Kansas,231,7794,7617,177,17,0,36,374,366,8,1,0,2,23-1000,"Lawyers, Judges, and Related Workers"
20,Kansas,232,2978,2855,123,0,0,88,152,143,9,0,0,7,23-2000,Legal Support Workers
20,Kansas,251,12703,9986,2717,0,444,106,614,510,104,0,10,4,25-1000,Postsecondary Teachers
20,Kansas,252,54128,52819,1309,55,43,179,3164,3107,57,3,4,8,25-2000,"Preschool, Elementary, Middle, Secondary, and Special Education Teachers"
20,Kansas,253,7089,6474,615,0,24,70,411,382,29,0,1,3,25-3000,Other Teachers and Instructors
20,Kansas,254,2768,2697,71,0,10,0,171,168,3,0,1,0,25-4000,"Librarians, Curators, and Archivists"
20,Kansas,259,16714,15518,1196,136,202,426,1119,1073,46,1,5,17,25-9000,Other Educational Instruction and Library Occupations
20,Kansas,271,8264,7925,339,0,44,97,429,414,15,0,1,3,27-1000,Art and Design Workers
20,Kansas,272,5716,5313,403,0,39,82,353,329,24,0,2,4,27-2000,"Entertainers and Performers, Sports and Related Workers"
20,Kansas,273,5528,5172,356,30,112,58,300,278,22,1,3,2,27-3000,Media and Communication Workers
20,Kansas,274,2358,2248,110,0,0,0,155,147,8,0,0,0,27-4000,Media and Communication Equipment Workers
20,Kansas,291,61497,57354,4143,27,113,190,3130,2962,168,1,7,17,29-1000,Healthcare Diagnosing or Treating Practitioners
20,Kansas,292,25937,24666,1271,11,60,440,1428,1363,65,1,3,21,29-2000,Health Technologists and Technicians
20,Kansas,299,891,874,17,0,17,0,46,45,1,0,1,0,29-9000,Other Healthcare Practitioners and Technical Occupations
20,Kansas,3111,29693,27705,1988,85,89,467,1809,1731,78,4,2,25,31-1100,"Home Health and Personal Care Aides; and Nursing Assistants, Orderlies, and Psychiatric Aides"
20,Kansas,312,1923,1855,68,0,18,0,118,114,4,0,1,0,31-2000,Occupational Therapy and Physical Therapist Assistants and Aides
20,Kansas,319,10404,9740,664,0,37,242,591,558,33,0,2,15,31-9000,Other Healthcare Support Occupations
20,Kansas,331,2868,2868,0,0,0,0,164,163,1,0,0,0,33-1000,Supervisors of Protective Service Workers
20,Kansas,332,2503,2479,24,0,0,24,129,127,2,0,0,2,33-2000,Firefighting and Prevention Workers
20,Kansas,333,10867,10703,164,0,0,34,591,582,9,0,0,2,33-3000,Law Enforcement Workers
20,Kansas,339,7546,7249,297,60,18,27,591,577,14,3,1,2,33-9000,Other Protective Service Workers
20,Kansas,351,7371,6512,859,0,0,372,353,317,36,0,1,17,35-1000,Supervisors of Food Preparation and Serving Workers
20,Kansas,352,29466,23741,5725,1117,73,3543,1783,1581,202,21,5,119,35-2000,Cooks and Food Preparation Workers
20,Kansas,353,29833,26769,3064,166,206,1106,1640,1516,124,9,8,52,35-3000,Food and Beverage Serving Workers
20,Kansas,359,7087,6440,647,104,0,233,507,471,36,5,0,12,35-9000,Other Food Preparation and Serving Related Workers
20,Kansas,371,3176,2914,262,28,16,181,134,122,12,1,1,9,37-1000,Supervisors of Building and Grounds Cleaning and Maintenance Workers
20,Kansas,372,33071,24914,8157,1500,476,5354,2016,1713,303,47,16,194,37-2000,Building Cleaning and Pest Control Workers
20,Kansas,373,9683,8282,1401,175,20,1149,675,628,47,4,2,36,37-3000,Grounds Maintenance Workers
20,Kansas,391,697,697,0,0,0,0,34,31,3,0,0,0,39-1000,Supervisors of Personal Care and Service Workers
20,Kansas,392,2871,2749,122,0,29,64,149,142,7,0,1,3,39-2000,Animal Care and Service Workers
20,Kansas,393,2310,2141,169,0,70,59,140,132,8,0,2,1,39-3000,Entertainment Attendants and Related Workers
20,Kansas,394,549,549,0,0,0,0,34,34,0,0,0,0,39-4000,Funeral Service Workers
20,Kansas,395,9451,7935,1516,0,15,72,457,399,58,0,1,4,39-5000,Personal Appearance Workers
20,Kansas,396,69,69,0,0,0,0,4,4,0,0,0,0,39-6000,"Baggage Porters, Bellhops, and Concierges"
20,Kansas,397,205,179,26,0,0,0,21,20,1,0,0,0,39-7000,Tour and Travel Guides
20,Kansas,399,19487,18089,1398,136,100,726,1347,1285,62,3,5,26,39-9000,Other Personal Care and Service Workers
20,Kansas,411,36692,34133,2559,166,61,861,1934,1833,101,6,4,34,41-1000,Supervisors of Sales Workers
20,Kansas,412,53454,50132,3322,249,38,1295,3183,3008,175,10,4,60,41-2000,Retail Sales Workers
20,Kansas,413,13420,13089,331,20,0,142,725,710,15,1,1,3,41-3000,"Sales Representatives, Services"
20,Kansas,414,11142,10698,444,0,34,187,592,572,20,0,1,8,41-4000,"Sales Representatives, Wholesale and Manufacturing"
20,Kansas,419,8686,8428,258,0,20,0,492,475,17,0,2,1,41-9000,Other Sales and Related Workers
20,Kansas,431,10642,10310,332,0,23,152,604,589,15,0,2,5,43-1000,Supervisors of Office and Administrative Support Workers
20,Kansas,432,782,628,154,0,0,154,27,25,2,0,0,1,43-2000,Communications Equipment Operators
20,Kansas,433,22599,21725,874,30,0,288,1355,1311,44,2,1,15,43-3000,Financial Clerks
20,Kansas,434,46409,44434,1975,56,73,802,2481,2390,91,3,5,26,43-4000,Information and Record Clerks
20,Kansas,435,18121,16931,1190,52,96,326,1101,1051,50,3,1,17,43-5000,"Material Recording, Scheduling, Dispatching, and Distributing Workers"
20,Kansas,436,26935,25920,1015,107,29,548,1810,1761,49,2,7,21,43-6000,Secretaries and Administrative Assistants
20,Kansas,439,24547,23050,1497,138,136,466,1426,1357,69,3,4,19,43-9000,Other Office and Administrative Support Workers
20,Kansas,451,374,354,20,0,0,2,32,29,3,0,0,2,45-1000,"Supervisors of Farming, Fishing, and Forestry Workers"
20,Kansas,452,10732,8403,2329,358,0,1848,903,778,125,13,0,104,45-2000,Agricultural Workers
20,Kansas,453,5,5,0,0,0,0,5,5,0,0,0,0,45-3000,Fishing and Hunting Workers
20,Kansas,454,169,169,0,0,0,0,17,17,0,0,0,0,45-4000,"Forest, Conservation, and Logging Workers"
20,Kansas,471,7202,6647,555,85,0,423,421,398,23,3,0,15,47-1000,Supervisors of Construction and Extraction Workers
20,Kansas,472,58037,44523,13514,2183,281,10221,3191,2794,397,65,6,292,47-2000,Construction Trades Workers
20,Kansas,473,167,124,43,0,0,43,26,25,1,0,0,1,47-3000,"Helpers, Construction Trades"
20,Kansas,474,3343,3240,103,10,0,93,191,186,5,1,0,4,47-4000,Other Construction and Related Workers
20,Kansas,475,2361,1895,466,0,0,463,177,164,13,0,0,12,47-5000,Extraction Workers
20,Kansas,491,3118,3009,109,0,0,109,177,173,4,0,0,4,49-1000,"Supervisors of Installation, Maintenance, and Repair Workers"
20,Kansas,492,4145,3706,439,0,0,220,249,233,16,0,0,8,49-2000,"Electrical and Electronic Equipment Mechanics, Installers, and Repairers"
20,Kansas,493,20096,18548,1548,0,0,1023,1122,1063,59,0,0,39,49-3000,"Vehicle and Mobile Equipment Mechanics, Installers, and Repairers"
20,Kansas,499,20172,18696,1476,57,13,1194,1136,1085,51,3,1,34,49-9000,"Other Installation, Maintenance, and Repair Occupations"
20,Kansas,511,10046,8985,1061,141,0,570,562,521,41,4,0,24,51-1000,Supervisors of Production Workers
20,Kansas,512,13762,11103,2659,455,19,430,676,588,88,6,2,23,51-2000,Assemblers and Fabricators
20,Kansas,513,10569,6057,4512,688,26,2348,492,333,159,15,2,89,51-3000,Food Processing Workers
20,Kansas,514,18561,15180,3381,221,22,1759,1113,999,114,6,1,59,51-4000,Metal Workers and Plastic Workers
20,Kansas,5151,3445,3159,286,33,0,160,162,150,12,1,0,7,51-5100,Printing Workers
20,Kansas,516,2701,1899,802,0,0,411,197,158,39,1,0,18,51-6000,"Textile, Apparel, and Furnishings Workers"
20,Kansas,517,1212,1094,118,22,0,28,68,64,4,1,0,1,51-7000,Woodworkers
20,Kansas,518,2709,2682,27,0,0,27,181,180,1,0,0,1,51-8000,Plant and System Operators
20,Kansas,519,35879,29917,5962,677,184,2775,1890,1683,207,20,5,94,51-9000,Other Production Occupations
20,Kansas,531,2119,2005,114,0,14,55,117,110,7,0,1,4,53-1000,Supervisors of Transportation and Material Moving Workers
20,Kansas,532,1907,1853,54,0,0,4,92,89,3,0,0,1,53-2000,Air Transportation Workers
20,Kansas,533,37591,34204,3387,479,0,1829,2205,2075,130,17,1,69,53-3000,Motor Vehicle Operators
20,Kansas,534,1987,1987,0,0,0,0,136,136,0,0,0,0,53-4000,Rail Transportation Workers
20,Kansas,535,40,40,0,0,0,0,4,3,1,0,0,0,53-5000,Water Transportation Workers
20,Kansas,536,1562,1449,113,0,0,0,99,97,2,0,0,0,53-6000,Other Transportation Workers
20,Kansas,537,57203,47869,9334,1089,54,5004,3328,2991,337,37,3,183,53-7000,Material Moving Workers
21,Kentucky,111,21561,20722,839,39,5,22,1247,1201,46,2,1,1,11-1000,Top Executives
21,Kentucky,112,9652,9283,369,134,0,23,594,578,16,3,0,1,11-2000,"Advertising, Marketing, Promotions, Public Relations, and Sales Managers"
21,Kentucky,113,33041,31359,1682,62,24,116,1951,1865,86,3,3,5,11-3000,Operations Specialties Managers
21,Kentucky,119,100702,95962,4740,148,326,1197,5612,5392,220,6,16,41,11-9000,Other Management Occupations
21,Kentucky,131,43950,42588,1362,121,69,62,2676,2579,97,5,6,5,13-1000,Business Operations Specialists
21,Kentucky,132,33244,32280,964,0,30,0,2031,1970,61,0,2,0,13-2000,Financial Specialists
21,Kentucky,1512,36942,32932,4010,111,84,212,2102,1916,186,3,5,6,15-1200,Computer Occupations
21,Kentucky,152,2040,1802,238,0,0,0,126,114,12,0,0,0,15-2000,Mathematical Science Occupations
21,Kentucky,171,1139,1093,46,0,0,0,75,72,3,0,0,0,17-1000,"Architects, Surveyors, and Cartographers"
21,Kentucky,172,18852,17516,1336,111,41,88,1092,1015,77,4,4,4,17-2000,Engineers
21,Kentucky,173,8169,7696,473,0,24,25,421,399,22,0,4,1,17-3000,"Drafters, Engineering Technicians, and Mapping Technicians"
21,Kentucky,191,2015,1761,254,0,18,0,119,102,17,0,2,0,19-1000,Life Scientists
21,Kentucky,192,2381,1911,470,0,2,0,148,122,26,0,2,0,19-2000,Physical Scientists
21,Kentucky,193,2319,2225,94,0,0,0,151,146,5,0,0,0,19-3000,Social Scientists and Related Workers
21,Kentucky,194,3936,3734,202,0,13,0,237,223,14,0,1,0,19-4000,"Life, Physical, and Social Science Technicians"
21,Kentucky,195,786,786,0,0,0,0,50,50,0,0,0,0,19-5000,Occupational Health and Safety Specialists and Technicians
21,Kentucky,211,26987,26373,614,0,85,61,1504,1464,40,0,5,2,21-1000,"Counselors, Social Workers, and Other Community and Social Service Specialists"
21,Kentucky,212,7543,6964,579,25,0,110,463,435,28,1,0,4,21-2000,Religious Workers
21,Kentucky,231,10875,10803,72,7,0,0,680,671,9,1,0,0,23-1000,"Lawyers, Judges, and Related Workers"
21,Kentucky,232,5335,5282,53,0,0,0,307,302,5,0,0,0,23-2000,Legal Support Workers
21,Kentucky,251,15650,12504,3146,82,282,63,984,820,164,3,12,3,25-1000,Postsecondary Teachers
21,Kentucky,252,65116,63323,1793,89,126,137,4076,3972,104,3,9,8,25-2000,"Preschool, Elementary, Middle, Secondary, and Special Education Teachers"
21,Kentucky,253,8983,8427,556,0,9,46,593,561,32,0,2,2,25-3000,Other Teachers and Instructors
21,Kentucky,254,3342,3200,142,0,0,0,226,219,7,0,0,0,25-4000,"Librarians, Curators, and Archivists"
21,Kentucky,259,15943,15191,752,54,53,57,1071,1026,45,2,5,5,25-9000,Other Educational Instruction and Library Occupations
21,Kentucky,271,7947,7464,483,0,17,18,547,519,28,0,3,1,27-1000,Art and Design Workers
21,Kentucky,272,6029,5762,267,31,46,23,432,412,20,1,3,1,27-2000,"Entertainers and Performers, Sports and Related Workers"
21,Kentucky,273,6341,5873,468,34,19,25,405,376,29,2,4,3,27-3000,Media and Communication Workers
21,Kentucky,274,2744,2683,61,0,0,0,169,164,5,0,0,0,27-4000,Media and Communication Equipment Workers
21,Kentucky,291,88804,84323,4481,0,312,315,5083,4838,245,0,16,7,29-1000,Healthcare Diagnosing or Treating Practitioners
21,Kentucky,292,42607,41311,1296,111,29,96,2361,2303,58,2,3,1,29-2000,Health Technologists and Technicians
21,Kentucky,299,1031,1031,0,0,0,0,62,62,0,0,0,0,29-9000,Other Healthcare Practitioners and Technical Occupations
21,Kentucky,3111,34584,33464,1120,0,9,30,2001,1941,60,0,1,4,31-1100,"Home Health and Personal Care Aides; and Nursing Assistants, Orderlies, and Psychiatric Aides"
21,Kentucky,312,2358,2272,86,0,0,0,133,131,2,0,0,0,31-2000,Occupational Therapy and Physical Therapist Assistants and Aides
21,Kentucky,319,17186,16582,604,21,0,77,994,960,34,3,0,3,31-9000,Other Healthcare Support Occupations
21,Kentucky,331,3060,3060,0,0,0,0,197,197,0,0,0,0,33-1000,Supervisors of Protective Service Workers
21,Kentucky,332,3508,3498,10,0,0,0,193,192,1,0,0,0,33-2000,Firefighting and Prevention Workers
21,Kentucky,333,14636,14579,57,18,0,10,806,800,6,2,0,1,33-3000,Law Enforcement Workers
21,Kentucky,339,14113,13840,273,0,17,79,934,915,19,0,4,2,33-9000,Other Protective Service Workers
21,Kentucky,351,11027,10276,751,25,100,100,606,571,35,1,2,7,35-1000,Supervisors of Food Preparation and Serving Workers
21,Kentucky,352,43854,40103,3751,529,60,1648,2723,2584,139,23,2,51,35-2000,Cooks and Food Preparation Workers
21,Kentucky,353,41148,39442,1706,102,16,490,2414,2313,101,7,2,26,35-3000,Food and Beverage Serving Workers
21,Kentucky,359,10127,9399,728,121,0,255,745,711,34,5,0,8,35-9000,Other Food Preparation and Serving Related Workers
21,Kentucky,371,4960,4682,278,7,21,143,233,221,12,1,1,5,37-1000,Supervisors of Building and Grounds Cleaning and Maintenance Workers
21,Kentucky,372,45590,41673,3917,760,74,1764,2807,2659,148,27,5,55,37-2000,Building Cleaning and Pest Control Workers
21,Kentucky,373,13820,12364,1456,313,0,915,901,846,55,10,0,32,37-3000,Grounds Maintenance Workers
21,Kentucky,391,808,668,140,0,0,0,45,42,3,0,0,0,39-1000,Supervisors of Personal Care and Service Workers
21,Kentucky,392,5068,4198,870,56,59,643,273,243,30,3,1,18,39-2000,Animal Care and Service Workers
21,Kentucky,393,3136,3078,58,24,0,0,242,237,5,1,0,0,39-3000,Entertainment Attendants and Related Workers
21,Kentucky,394,864,864,0,0,0,0,51,51,0,0,0,0,39-4000,Funeral Service Workers
21,Kentucky,395,13118,11284,1834,96,57,0,678,603,75,1,1,2,39-5000,Personal Appearance Workers
21,Kentucky,396,413,413,0,0,0,0,23,23,0,0,0,0,39-6000,"Baggage Porters, Bellhops, and Concierges"
21,Kentucky,397,862,840,22,0,0,0,53,50,3,0,0,0,39-7000,Tour and Travel Guides
21,Kentucky,399,21012,20109,903,0,30,175,1502,1450,52,1,3,10,39-9000,Other Personal Care and Service Workers
21,Kentucky,411,54462,52515,1947,60,145,277,2965,2875,90,4,7,10,41-1000,Supervisors of Sales Workers
21,Kentucky,412,85067,81300,3767,76,156,533,5511,5330,181,4,9,19,41-2000,Retail Sales Workers
21,Kentucky,413,15999,15510,489,0,52,0,918,897,21,0,2,0,41-3000,"Sales Representatives, Services"
21,Kentucky,414,15362,14813,549,65,25,25,906,871,35,3,4,2,41-4000,"Sales Representatives, Wholesale and Manufacturing"
21,Kentucky,419,11137,10837,300,0,0,0,706,690,16,0,0,0,41-9000,Other Sales and Related Workers
21,Kentucky,431,15233,14905,328,0,45,0,911,890,21,0,2,1,43-1000,Supervisors of Office and Administrative Support Workers
21,Kentucky,432,720,676,44,0,0,0,57,56,1,0,0,0,43-2000,Communications Equipment Operators
21,Kentucky,433,31319,30482,837,0,125,21,1823,1778,45,0,4,1,43-3000,Financial Clerks
21,Kentucky,434,68007,65879,2128,249,152,309,3982,3861,121,12,6,14,43-4000,Information and Record Clerks
21,Kentucky,435,29954,28254,1700,50,11,161,1686,1628,58,1,2,5,43-5000,"Material Recording, Scheduling, Dispatching, and Distributing Workers"
21,Kentucky,436,33894,33335,559,27,78,3,2254,2218,36,1,3,1,43-6000,Secretaries and Administrative Assistants
21,Kentucky,439,38303,36812,1491,50,83,236,2333,2263,70,3,8,6,43-9000,Other Office and Administrative Support Workers
21,Kentucky,451,574,564,10,0,0,0,31,30,1,0,0,0,45-1000,"Supervisors of Farming, Fishing, and Forestry Workers"
21,Kentucky,452,9449,6241,3208,640,0,2060,593,501,92,17,1,61,45-2000,Agricultural Workers
21,Kentucky,453,15,15,0,0,0,0,3,3,0,0,0,0,45-3000,Fishing and Hunting Workers
21,Kentucky,454,2155,2120,35,35,0,0,120,119,1,1,0,0,45-4000,"Forest, Conservation, and Logging Workers"
21,Kentucky,471,9503,9353,150,0,0,74,567,555,12,0,0,7,47-1000,Supervisors of Construction and Extraction Workers
21,Kentucky,472,76044,69482,6562,1205,80,4322,4355,4142,213,43,5,120,47-2000,Construction Trades Workers
21,Kentucky,473,496,496,0,0,0,0,28,28,0,0,0,0,47-3000,"Helpers, Construction Trades"
21,Kentucky,474,4281,4129,152,36,8,19,242,235,7,1,1,1,47-4000,Other Construction and Related Workers
21,Kentucky,475,4627,4578,49,0,0,49,336,334,2,0,0,2,47-5000,Extraction Workers
21,Kentucky,491,4103,4037,66,0,0,12,234,230,4,0,0,1,49-1000,"Supervisors of Installation, Maintenance, and Repair Workers"
21,Kentucky,492,6668,6339,329,13,0,0,359,347,12,1,0,0,49-2000,"Electrical and Electronic Equipment Mechanics, Installers, and Repairers"
21,Kentucky,493,24628,24140,488,98,0,149,1319,1289,30,4,0,7,49-3000,"Vehicle and Mobile Equipment Mechanics, Installers, and Repairers"
21,Kentucky,499,31860,31172,688,51,0,223,1809,1775,34,3,0,11,49-9000,"Other Installation, Maintenance, and Repair Occupations"
21,Kentucky,511,18981,18338,643,19,49,151,1053,1026,27,2,3,6,51-1000,Supervisors of Production Workers
21,Kentucky,512,33412,31428,1984,136,0,404,1829,1744,85,6,1,17,51-2000,Assemblers and Fabricators
21,Kentucky,513,10716,9237,1479,71,0,268,540,489,51,3,0,9,51-3000,Food Processing Workers
21,Kentucky,514,34317,31667,2650,336,99,692,1824,1746,78,8,2,15,51-4000,Metal Workers and Plastic Workers
21,Kentucky,5151,3595,3487,108,0,0,0,217,212,5,0,0,0,51-5100,Printing Workers
21,Kentucky,516,6181,5374,807,152,0,223,411,369,42,4,0,14,51-6000,"Textile, Apparel, and Furnishings Workers"
21,Kentucky,517,2283,2241,42,0,0,23,160,157,3,0,0,1,51-7000,Woodworkers
21,Kentucky,518,4089,4074,15,0,0,0,247,246,1,0,0,0,51-8000,Plant and System Operators
21,Kentucky,519,62460,56104,6356,718,176,1652,3411,3186,225,20,7,53,51-9000,Other Production Occupations
21,Kentucky,531,5030,4882,148,0,4,46,230,221,9,0,1,2,53-1000,Supervisors of Transportation and Material Moving Workers
21,Kentucky,532,2459,2428,31,0,0,0,148,145,3,0,0,0,53-2000,Air Transportation Workers
21,Kentucky,533,59163,55931,3232,173,55,130,3184,3070,114,4,3,5,53-3000,Motor Vehicle Operators
21,Kentucky,534,2010,2010,0,0,0,0,115,115,0,0,0,0,53-4000,Rail Transportation Workers
21,Kentucky,535,1167,1167,0,0,0,0,87,87,0,0,0,0,53-5000,Water Transportation Workers
21,Kentucky,536,3515,3499,16,0,0,0,206,203,3,0,0,0,53-6000,Other Transportation Workers
21,Kentucky,537,103696,95121,8575,1033,231,1852,5814,5511,303,28,13,53,53-7000,Material Moving Workers
22,Louisiana,111,22068,21258,810,91,37,96,1173,1132,41,3,1,3,11-1000,Top Executives
22,Louisiana,112,8715,8544,171,26,0,0,509,499,10,2,0,1,11-2000,"Advertising, Marketing, Promotions, Public Relations, and Sales Managers"
22,Louisiana,113,28942,27869,1073,307,53,101,1585,1524,61,13,5,5,11-3000,Operations Specialties Managers
22,Louisiana,119,104532,99088,5444,365,600,1162,5531,5264,267,23,22,36,11-9000,Other Management Occupations
22,Louisiana,131,39690,38221,1469,203,103,189,2325,2254,71,12,7,4,13-1000,Business Operations Specialists
22,Louisiana,132,33623,32501,1122,177,110,14,1835,1775,60,6,8,1,13-2000,Financial Specialists
22,Louisiana,1512,27699,25315,2384,108,51,82,1527,1415,112,7,2,2,15-1200,Computer Occupations
22,Louisiana,152,1315,1172,143,0,14,0,94,86,8,0,1,0,15-2000,Mathematical Science Occupations
22,Louisiana,171,2259,2241,18,0,7,0,136,133,3,0,1,0,17-1000,"Architects, Surveyors, and Cartographers"
22,Louisiana,172,21014,18463,2551,21,529,11,1140,1013,127,5,18,1,17-2000,Engineers
22,Louisiana,173,10522,10115,407,0,0,21,564,544,20,0,1,2,17-3000,"Drafters, Engineering Technicians, and Mapping Technicians"
22,Louisiana,191,2586,2333,253,0,6,0,160,142,18,0,1,0,19-1000,Life Scientists
22,Louisiana,192,4130,3490,640,21,63,0,259,223,36,1,4,0,19-2000,Physical Scientists
22,Louisiana,193,2271,2194,77,0,0,0,145,139,6,0,0,0,19-3000,Social Scientists and Related Workers
22,Louisiana,194,6002,5647,355,12,0,0,346,326,20,1,0,0,19-4000,"Life, Physical, and Social Science Technicians"
22,Louisiana,195,1350,1275,75,51,0,24,69,67,2,1,0,1,19-5000,Occupational Health and Safety Specialists and Technicians
22,Louisiana,211,25401,24675,726,168,31,17,1325,1288,37,7,2,1,21-1000,"Counselors, Social Workers, and Other Community and Social Service Specialists"
22,Louisiana,212,7471,6858,613,149,29,35,490,431,59,5,2,2,21-2000,Religious Workers
22,Louisiana,231,13805,13489,316,54,0,27,874,848,26,3,0,2,23-1000,"Lawyers, Judges, and Related Workers"
22,Louisiana,232,8682,8654,28,28,0,0,479,474,5,2,0,0,23-2000,Legal Support Workers
22,Louisiana,251,15242,11921,3321,95,137,50,937,751,186,3,10,4,25-1000,Postsecondary Teachers
22,Louisiana,252,71900,69964,1936,112,199,198,4257,4126,131,11,19,13,25-2000,"Preschool, Elementary, Middle, Secondary, and Special Education Teachers"
22,Louisiana,253,8095,7801,294,26,45,7,487,457,30,2,3,1,25-3000,Other Teachers and Instructors
22,Louisiana,254,3579,3539,40,0,0,0,241,239,2,0,0,0,25-4000,"Librarians, Curators, and Archivists"
22,Louisiana,259,16326,15616,710,159,69,64,986,943,43,6,4,4,25-9000,Other Educational Instruction and Library Occupations
22,Louisiana,271,10015,9699,316,46,72,57,611,577,34,4,9,5,27-1000,Art and Design Workers
22,Louisiana,272,8785,8520,265,90,42,0,542,513,29,2,2,0,27-2000,"Entertainers and Performers, Sports and Related Workers"
22,Louisiana,273,6638,6320,318,0,16,0,397,378,19,0,2,0,27-3000,Media and Communication Workers
22,Louisiana,274,3469,3376,93,16,31,0,221,214,7,1,1,0,27-4000,Media and Communication Equipment Workers
22,Louisiana,291,83714,79515,4199,158,198,40,4461,4228,233,12,14,4,29-1000,Healthcare Diagnosing or Treating Practitioners
22,Louisiana,292,46654,45791,863,77,72,0,2417,2355,62,8,5,1,29-2000,Health Technologists and Technicians
22,Louisiana,299,1462,1382,80,38,0,0,69,63,6,2,1,0,29-9000,Other Healthcare Practitioners and Technical Occupations
22,Louisiana,3111,48174,47598,576,57,68,71,2365,2325,40,7,3,3,31-1100,"Home Health and Personal Care Aides; and Nursing Assistants, Orderlies, and Psychiatric Aides"
22,Louisiana,312,2420,2241,179,24,0,37,131,123,8,1,0,1,31-2000,Occupational Therapy and Physical Therapist Assistants and Aides
22,Louisiana,319,16089,15726,363,20,6,0,792,770,22,2,1,0,31-9000,Other Healthcare Support Occupations
22,Louisiana,331,5511,5432,79,23,0,45,343,338,5,1,1,2,33-1000,Supervisors of Protective Service Workers
22,Louisiana,332,4799,4785,14,14,0,0,255,254,1,1,0,0,33-2000,Firefighting and Prevention Workers
22,Louisiana,333,23699,23437,262,62,15,46,1127,1111,16,3,2,1,33-3000,Law Enforcement Workers
22,Louisiana,339,16938,16617,321,65,24,4,988,971,17,3,1,1,33-9000,Other Protective Service Workers
22,Louisiana,351,14503,13402,1101,108,75,151,736,682,54,9,4,6,35-1000,Supervisors of Food Preparation and Serving Workers
22,Louisiana,352,50406,46599,3807,1278,67,502,2702,2545,157,43,3,28,35-2000,Cooks and Food Preparation Workers
22,Louisiana,353,52423,50240,2183,615,230,145,2810,2682,128,23,5,15,35-3000,Food and Beverage Serving Workers
22,Louisiana,359,11548,10611,937,160,23,534,722,682,40,8,1,17,35-9000,Other Food Preparation and Serving Related Workers
22,Louisiana,371,4697,4574,123,21,0,17,229,222,7,1,0,1,37-1000,Supervisors of Building and Grounds Cleaning and Maintenance Workers
22,Louisiana,372,55731,48343,7388,3891,434,1523,3048,2746,302,164,20,54,37-2000,Building Cleaning and Pest Control Workers
22,Louisiana,373,15008,13369,1639,630,11,611,904,843,61,24,1,22,37-3000,Grounds Maintenance Workers
22,Louisiana,391,1188,1064,124,0,0,30,72,66,6,0,0,1,39-1000,Supervisors of Personal Care and Service Workers
22,Louisiana,392,3461,3461,0,0,0,0,186,186,0,0,0,0,39-2000,Animal Care and Service Workers
22,Louisiana,393,6183,5822,361,21,0,0,307,286,21,2,0,0,39-3000,Entertainment Attendants and Related Workers
22,Louisiana,394,955,912,43,32,0,11,47,45,2,1,0,1,39-4000,Funeral Service Workers
22,Louisiana,395,17779,14863,2916,132,0,117,905,757,148,11,1,7,39-5000,Personal Appearance Workers
22,Louisiana,396,936,936,0,0,0,0,42,42,0,0,0,0,39-6000,"Baggage Porters, Bellhops, and Concierges"
22,Louisiana,397,1028,926,102,0,11,0,77,71,6,1,1,0,39-7000,Tour and Travel Guides
22,Louisiana,399,21076,20233,843,330,69,141,1436,1382,54,15,8,7,39-9000,Other Personal Care and Service Workers
22,Louisiana,411,58986,57010,1976,282,67,223,2930,2822,108,10,5,9,41-1000,Supervisors of Sales Workers
22,Louisiana,412,96044,92154,3890,367,186,446,5385,5187,198,18,10,16,41-2000,Retail Sales Workers
22,Louisiana,413,15780,15377,403,71,15,0,850,826,24,5,1,1,41-3000,"Sales Representatives, Services"
22,Louisiana,414,17430,16896,534,144,36,6,902,873,29,7,4,1,41-4000,"Sales Representatives, Wholesale and Manufacturing"
22,Louisiana,419,11763,11474,289,50,0,23,683,660,23,3,0,1,41-9000,Other Sales and Related Workers
22,Louisiana,431,17627,17319,308,16,55,72,976,957,19,2,2,2,43-1000,Supervisors of Office and Administrative Support Workers
22,Louisiana,432,1426,1390,36,0,0,0,79,78,1,0,0,0,43-2000,Communications Equipment Operators
22,Louisiana,433,32883,32070,813,122,81,35,1875,1836,39,3,3,3,43-3000,Financial Clerks
22,Louisiana,434,56051,54284,1767,201,122,231,3004,2896,108,16,7,7,43-4000,Information and Record Clerks
22,Louisiana,435,24452,23938,514,124,58,41,1323,1295,28,4,3,3,43-5000,"Material Recording, Scheduling, Dispatching, and Distributing Workers"
22,Louisiana,436,44663,43829,834,109,109,77,2786,2721,65,11,6,7,43-6000,Secretaries and Administrative Assistants
22,Louisiana,439,35452,34504,948,351,117,88,2094,2039,55,13,5,4,43-9000,Other Office and Administrative Support Workers
22,Louisiana,451,985,907,78,35,0,15,50,46,4,1,0,2,45-1000,"Supervisors of Farming, Fishing, and Forestry Workers"
22,Louisiana,452,5865,4616,1249,164,2,993,400,315,85,7,1,70,45-2000,Agricultural Workers
22,Louisiana,453,3306,2068,1238,92,0,16,213,151,62,1,0,1,45-3000,Fishing and Hunting Workers
22,Louisiana,454,1002,973,29,0,0,19,91,87,4,0,0,3,45-4000,"Forest, Conservation, and Logging Workers"
22,Louisiana,471,19235,18515,720,183,22,372,946,917,29,9,3,9,47-1000,Supervisors of Construction and Extraction Workers
22,Louisiana,472,101753,81849,19904,10388,643,6402,4887,4307,580,282,21,181,47-2000,Construction Trades Workers
22,Louisiana,473,1619,1400,219,0,55,45,93,85,8,0,1,1,47-3000,"Helpers, Construction Trades"
22,Louisiana,474,3302,3141,161,0,0,126,185,179,6,0,0,3,47-4000,Other Construction and Related Workers
22,Louisiana,475,12282,12103,179,7,24,79,630,622,8,1,1,2,47-5000,Extraction Workers
22,Louisiana,491,5715,5630,85,23,30,0,267,261,6,2,2,0,49-1000,"Supervisors of Installation, Maintenance, and Repair Workers"
22,Louisiana,492,7101,6889,212,66,0,0,351,340,11,2,0,0,49-2000,"Electrical and Electronic Equipment Mechanics, Installers, and Repairers"
22,Louisiana,493,26142,25110,1032,389,81,225,1293,1249,44,14,3,8,49-3000,"Vehicle and Mobile Equipment Mechanics, Installers, and Repairers"
22,Louisiana,499,35172,33660,1512,402,50,486,1797,1734,63,15,3,13,49-9000,"Other Installation, Maintenance, and Repair Occupations"
22,Louisiana,511,14068,13609,459,153,6,34,720,703,17,3,1,1,51-1000,Supervisors of Production Workers
22,Louisiana,512,4802,4419,383,49,0,0,269,252,17,3,0,0,51-2000,Assemblers and Fabricators
22,Louisiana,513,8233,7596,637,201,0,216,455,415,40,9,0,13,51-3000,Food Processing Workers
22,Louisiana,514,24242,22830,1412,390,31,458,1138,1076,62,13,3,16,51-4000,Metal Workers and Plastic Workers
22,Louisiana,5151,1464,1427,37,0,2,0,73,68,5,0,1,0,51-5100,Printing Workers
22,Louisiana,516,5069,4352,717,189,15,83,298,261,37,8,1,3,51-6000,"Textile, Apparel, and Furnishings Workers"
22,Louisiana,517,1292,1218,74,0,24,27,77,73,4,0,1,2,51-7000,Woodworkers
22,Louisiana,518,6545,6267,278,42,0,0,347,333,14,3,0,0,51-8000,Plant and System Operators
22,Louisiana,519,39481,38043,1438,535,51,158,2028,1971,57,13,4,7,51-9000,Other Production Occupations
22,Louisiana,531,3917,3749,168,108,0,0,205,197,8,2,0,0,53-1000,Supervisors of Transportation and Material Moving Workers
22,Louisiana,532,2496,2438,58,0,0,0,143,139,4,0,0,0,53-2000,Air Transportation Workers
22,Louisiana,533,60429,58596,1833,349,50,155,3003,2915,88,15,2,10,53-3000,Motor Vehicle Operators
22,Louisiana,534,2053,2053,0,0,0,0,100,100,0,0,0,0,53-4000,Rail Transportation Workers
22,Louisiana,535,8888,8550,338,112,0,73,442,432,10,5,0,1,53-5000,Water Transportation Workers
22,Louisiana,536,3633,3509,124,0,0,38,198,189,9,1,0,1,53-6000,Other Transportation Workers
22,Louisiana,537,65952,63861,2091,535,47,322,3578,3473,105,18,3,17,53-7000,Material Moving Workers
23,Maine,111,9257,8859,398,0,0,0,412,392,20,0,0,0,11-1000,Top Executives
23,Maine,112,3105,3048,57,0,0,0,135,132,3,0,0,0,11-2000,"Advertising, Marketing, Promotions, Public Relations, and Sales Managers"
23,Maine,113,11686,11268,418,0,0,25,509,493,16,0,0,1,11-3000,Operations Specialties Managers
23,Maine,119,36440,35156,1284,0,9,5,1884,1829,55,0,3,1,11-9000,Other Management Occupations
23,Maine,131,17334,16824,510,58,109,41,789,765,24,1,4,2,13-1000,Business Operations Specialists
23,Maine,132,11641,11242,399,0,8,0,534,518,16,0,1,0,13-2000,Financial Specialists
23,Maine,1512,12509,11782,727,0,75,0,607,573,34,1,1,0,15-1200,Computer Occupations
23,Maine,152,752,752,0,0,0,0,38,38,0,0,0,0,15-2000,Mathematical Science Occupations
23,Maine,171,707,663,44,0,0,44,40,39,1,0,0,1,17-1000,"Architects, Surveyors, and Cartographers"
23,Maine,172,6757,6655,102,0,0,0,295,289,6,0,0,0,17-2000,Engineers
23,Maine,173,3248,3248,0,0,0,0,155,153,2,0,0,0,17-3000,"Drafters, Engineering Technicians, and Mapping Technicians"
23,Maine,191,995,990,5,0,0,0,62,61,1,0,0,0,19-1000,Life Scientists
23,Maine,192,1608,1532,76,0,14,0,72,69,3,0,1,0,19-2000,Physical Scientists
23,Maine,193,1082,1065,17,0,0,0,46,45,1,0,0,0,19-3000,Social Scientists and Related Workers
23,Maine,194,1658,1596,62,0,0,0,97,90,7,0,0,0,19-4000,"Life, Physical, and Social Science Technicians"
23,Maine,195,199,199,0,0,0,0,11,11,0,0,0,0,19-5000,Occupational Health and Safety Specialists and Technicians
23,Maine,211,11570,11015,555,0,43,0,639,620,19,0,1,0,21-1000,"Counselors, Social Workers, and Other Community and Social Service Specialists"
23,Maine,212,1385,1289,96,0,0,0,67,63,4,0,0,0,21-2000,Religious Workers
23,Maine,231,2868,2864,4,0,0,0,138,135,3,0,1,0,23-1000,"Lawyers, Judges, and Related Workers"
23,Maine,232,1541,1504,37,0,0,0,88,82,6,0,2,0,23-2000,Legal Support Workers
23,Maine,251,5547,4885,662,0,44,0,267,237,30,0,1,0,25-1000,Postsecondary Teachers
23,Maine,252,27802,27262,540,13,35,0,1469,1435,34,2,2,0,25-2000,"Preschool, Elementary, Middle, Secondary, and Special Education Teachers"
23,Maine,253,3011,2842,169,0,13,41,210,203,7,0,1,1,25-3000,Other Teachers and Instructors
23,Maine,254,1174,1131,43,0,0,0,68,65,3,0,0,0,25-4000,"Librarians, Curators, and Archivists"
23,Maine,259,4436,4328,108,0,0,0,286,274,12,0,0,0,25-9000,Other Educational Instruction and Library Occupations
23,Maine,271,4036,3907,129,0,0,0,239,232,7,0,0,0,27-1000,Art and Design Workers
23,Maine,272,2724,2563,161,0,32,0,158,150,8,0,1,0,27-2000,"Entertainers and Performers, Sports and Related Workers"
23,Maine,273,3071,3009,62,0,0,0,175,169,6,0,0,1,27-3000,Media and Communication Workers
23,Maine,274,999,999,0,0,0,0,57,53,4,0,0,0,27-4000,Media and Communication Equipment Workers
23,Maine,291,28765,26923,1842,0,103,0,1371,1296,75,0,4,0,29-1000,Healthcare Diagnosing or Treating Practitioners
23,Maine,292,12522,11779,743,0,55,0,598,575,23,0,2,0,29-2000,Health Technologists and Technicians
23,Maine,299,737,705,32,0,0,0,26,25,1,0,0,0,29-9000,Other Healthcare Practitioners and Technical Occupations
23,Maine,3111,18200,17136,1064,50,0,0,990,940,50,1,0,0,31-1100,"Home Health and Personal Care Aides; and Nursing Assistants, Orderlies, and Psychiatric Aides"
23,Maine,312,457,457,0,0,0,0,21,21,0,0,0,0,31-2000,Occupational Therapy and Physical Therapist Assistants and Aides
23,Maine,319,6495,6202,293,0,0,0,308,300,8,0,0,0,31-9000,Other Healthcare Support Occupations
23,Maine,331,888,861,27,0,0,27,53,51,2,0,0,1,33-1000,Supervisors of Protective Service Workers
23,Maine,332,1510,1494,16,0,0,0,72,71,1,0,0,0,33-2000,Firefighting and Prevention Workers
23,Maine,333,4222,4177,45,0,35,0,233,230,3,0,1,0,33-3000,Law Enforcement Workers
23,Maine,339,3542,3486,56,0,0,0,226,221,5,0,0,0,33-9000,Other Protective Service Workers
23,Maine,351,3664,3401,263,32,60,0,184,171,13,1,1,1,35-1000,Supervisors of Food Preparation and Serving Workers
23,Maine,352,13753,12772,981,30,72,0,862,818,44,1,3,0,35-2000,Cooks and Food Preparation Workers
23,Maine,353,13972,13771,201,27,65,0,784,770,14,1,2,0,35-3000,Food and Beverage Serving Workers
23,Maine,359,4244,4139,105,0,0,0,280,273,7,0,0,0,35-9000,Other Food Preparation and Serving Related Workers
23,Maine,371,1567,1459,108,0,0,0,82,80,2,0,0,0,37-1000,Supervisors of Building and Grounds Cleaning and Maintenance Workers
23,Maine,372,16391,15310,1081,90,0,97,939,883,56,2,2,4,37-2000,Building Cleaning and Pest Control Workers
23,Maine,373,4880,4637,243,0,0,0,406,397,9,0,0,0,37-3000,Grounds Maintenance Workers
23,Maine,391,451,396,55,0,0,0,21,19,2,0,0,0,39-1000,Supervisors of Personal Care and Service Workers
23,Maine,392,1579,1558,21,0,0,0,87,83,4,0,0,0,39-2000,Animal Care and Service Workers
23,Maine,393,1275,1268,7,0,0,0,101,100,1,0,0,0,39-3000,Entertainment Attendants and Related Workers
23,Maine,394,190,190,0,0,0,0,6,6,0,0,0,0,39-4000,Funeral Service Workers
23,Maine,395,3725,3492,233,15,0,0,166,154,12,1,0,0,39-5000,Personal Appearance Workers
23,Maine,396,35,35,0,0,0,0,3,3,0,0,0,0,39-6000,"Baggage Porters, Bellhops, and Concierges"
23,Maine,397,663,663,0,0,0,0,42,41,1,0,1,0,39-7000,Tour and Travel Guides
23,Maine,399,8807,8280,527,0,104,0,571,540,31,1,8,0,39-9000,Other Personal Care and Service Workers
23,Maine,411,20801,20440,361,5,0,0,1017,992,25,1,0,0,41-1000,Supervisors of Sales Workers
23,Maine,412,27057,26074,983,84,45,0,1611,1562,49,2,1,0,41-2000,Retail Sales Workers
23,Maine,413,5549,5503,46,0,0,0,245,242,3,0,0,0,41-3000,"Sales Representatives, Services"
23,Maine,414,3989,3859,130,0,25,0,184,179,5,0,1,0,41-4000,"Sales Representatives, Wholesale and Manufacturing"
23,Maine,419,3864,3729,135,0,0,0,199,192,7,0,0,0,41-9000,Other Sales and Related Workers
23,Maine,431,4623,4521,102,0,0,0,262,257,5,0,0,0,43-1000,Supervisors of Office and Administrative Support Workers
23,Maine,432,322,303,19,0,0,0,20,19,1,0,0,0,43-2000,Communications Equipment Operators
23,Maine,433,11194,10949,245,0,0,0,565,560,5,0,0,0,43-3000,Financial Clerks
23,Maine,434,22084,21269,815,0,148,28,1142,1101,41,0,2,1,43-4000,Information and Record Clerks
23,Maine,435,8592,8112,480,0,0,0,445,435,10,0,0,0,43-5000,"Material Recording, Scheduling, Dispatching, and Distributing Workers"
23,Maine,436,13729,13406,323,0,0,0,771,755,16,0,0,0,43-6000,Secretaries and Administrative Assistants
23,Maine,439,12071,11585,486,0,0,0,621,597,24,0,0,0,43-9000,Other Office and Administrative Support Workers
23,Maine,451,372,372,0,0,0,0,20,20,0,0,0,0,45-1000,"Supervisors of Farming, Fishing, and Forestry Workers"
23,Maine,452,2497,2444,53,0,0,0,268,260,8,0,0,0,45-2000,Agricultural Workers
23,Maine,453,4426,4355,71,0,53,0,384,378,6,1,1,0,45-3000,Fishing and Hunting Workers
23,Maine,454,1983,1942,41,0,0,0,176,174,2,0,0,0,45-4000,"Forest, Conservation, and Logging Workers"
23,Maine,471,3569,3514,55,0,0,0,216,215,1,0,0,0,47-1000,Supervisors of Construction and Extraction Workers
23,Maine,472,29077,28690,387,0,41,23,1710,1686,24,1,1,1,47-2000,Construction Trades Workers
23,Maine,473,430,430,0,0,0,0,26,24,2,0,0,2,47-3000,"Helpers, Construction Trades"
23,Maine,474,1485,1462,23,0,0,0,99,97,2,0,0,0,47-4000,Other Construction and Related Workers
23,Maine,475,154,154,0,0,0,0,16,16,0,0,0,0,47-5000,Extraction Workers
23,Maine,491,1578,1542,36,0,0,0,61,59,2,0,0,0,49-1000,"Supervisors of Installation, Maintenance, and Repair Workers"
23,Maine,492,1909,1909,0,0,0,0,90,90,0,0,0,0,49-2000,"Electrical and Electronic Equipment Mechanics, Installers, and Repairers"
23,Maine,493,9072,9046,26,0,0,0,474,471,3,1,0,0,49-3000,"Vehicle and Mobile Equipment Mechanics, Installers, and Repairers"
23,Maine,499,8919,8775,144,0,0,0,497,490,7,0,0,0,49-9000,"Other Installation, Maintenance, and Repair Occupations"
23,Maine,511,3758,3585,173,0,0,25,183,180,3,0,0,1,51-1000,Supervisors of Production Workers
23,Maine,512,2789,2622,167,0,0,0,143,136,7,0,0,0,51-2000,Assemblers and Fabricators
23,Maine,513,2888,2747,141,0,0,0,166,156,10,0,0,0,51-3000,Food Processing Workers
23,Maine,514,7490,7096,394,0,0,0,377,367,10,0,0,0,51-4000,Metal Workers and Plastic Workers
23,Maine,5151,563,480,83,0,0,0,23,22,1,0,0,0,51-5100,Printing Workers
23,Maine,516,2357,2146,211,0,0,0,154,148,6,0,0,0,51-6000,"Textile, Apparel, and Furnishings Workers"
23,Maine,517,978,939,39,0,0,0,79,77,2,0,0,0,51-7000,Woodworkers
23,Maine,518,1471,1448,23,0,0,0,77,76,1,0,0,0,51-8000,Plant and System Operators
23,Maine,519,12733,12017,716,0,22,0,725,697,28,0,1,0,51-9000,Other Production Occupations
23,Maine,531,723,712,11,0,0,0,41,40,1,0,0,0,53-1000,Supervisors of Transportation and Material Moving Workers
23,Maine,532,521,490,31,0,0,0,26,24,2,0,0,0,53-2000,Air Transportation Workers
23,Maine,533,16329,15965,364,10,0,46,911,893,18,1,0,1,53-3000,Motor Vehicle Operators
23,Maine,534,356,356,0,0,0,0,18,18,0,0,0,0,53-4000,Rail Transportation Workers
23,Maine,535,1311,1269,42,0,0,0,89,88,1,0,0,0,53-5000,Water Transportation Workers
23,Maine,536,616,591,25,0,0,0,41,40,1,0,0,0,53-6000,Other Transportation Workers
23,Maine,537,20193,19207,986,154,0,103,1155,1117,38,3,0,2,53-7000,Material Moving Workers
24,Maryland,111,39470,34614,4856,260,624,139,2293,2005,288,19,34,8,11-1000,Top Executives
24,Maryland,112,19639,17927,1712,65,211,80,1102,996,106,5,10,4,11-2000,"Advertising, Marketing, Promotions, Public Relations, and Sales Managers"
24,Maryland,113,71128,60151,10977,689,834,166,4111,3490,621,40,44,8,11-3000,Operations Specialties Managers
24,Maryland,119,197331,166432,30899,4014,2508,1238,10963,9433,1530,150,129,42,11-9000,Other Management Occupations
24,Maryland,131,120637,104958,15679,737,1141,248,6830,5998,832,40,71,15,13-1000,Business Operations Specialists
24,Maryland,132,78074,63386,14688,610,911,111,4346,3582,764,32,53,7,13-2000,Financial Specialists
24,Maryland,1512,142450,110250,32200,717,1361,395,7714,6091,1623,43,66,14,15-1200,Computer Occupations
24,Maryland,152,18546,15402,3144,156,25,25,1038,865,173,6,3,2,15-2000,Mathematical Science Occupations
24,Maryland,171,5963,4878,1085,24,11,0,350,287,63,2,1,0,17-1000,"Architects, Surveyors, and Cartographers"
24,Maryland,172,44456,35694,8762,454,472,109,2530,2059,471,21,28,4,17-2000,Engineers
24,Maryland,173,10966,9536,1430,197,42,80,613,530,83,9,3,2,17-3000,"Drafters, Engineering Technicians, and Mapping Technicians"
24,Maryland,191,13904,7215,6689,0,231,16,825,451,374,1,11,3,19-1000,Life Scientists
24,Maryland,192,18919,11552,7367,147,235,112,1086,674,412,7,13,6,19-2000,Physical Scientists
24,Maryland,193,10394,8371,2023,67,361,26,663,541,122,4,20,3,19-3000,Social Scientists and Related Workers
24,Maryland,194,8589,6990,1599,225,74,0,563,467,96,7,7,0,19-4000,"Life, Physical, and Social Science Technicians"
24,Maryland,195,1213,1004,209,0,0,0,79,66,13,0,0,0,19-5000,Occupational Health and Safety Specialists and Technicians
24,Maryland,211,44534,39171,5363,455,521,77,2389,2134,255,24,26,3,21-1000,"Counselors, Social Workers, and Other Community and Social Service Specialists"
24,Maryland,212,10032,7487,2545,316,233,25,613,470,143,11,36,7,21-2000,Religious Workers
24,Maryland,231,31856,29319,2537,31,103,62,1952,1791,161,4,7,3,23-1000,"Lawyers, Judges, and Related Workers"
24,Maryland,232,14098,12369,1729,63,184,22,785,693,92,4,11,1,23-2000,Legal Support Workers
24,Maryland,251,27391,19440,7951,41,443,169,1771,1282,489,8,32,8,25-1000,Postsecondary Teachers
24,Maryland,252,103619,93608,10011,561,823,144,6174,5605,569,31,52,14,25-2000,"Preschool, Elementary, Middle, Secondary, and Special Education Teachers"
24,Maryland,253,16318,13937,2381,94,465,70,1107,951,156,7,22,5,25-3000,Other Teachers and Instructors
24,Maryland,254,7929,6943,986,0,57,0,528,475,53,0,3,0,25-4000,"Librarians, Curators, and Archivists"
24,Maryland,259,25756,21220,4536,381,541,263,1598,1340,258,29,29,8,25-9000,Other Educational Instruction and Library Occupations
24,Maryland,271,18295,15408,2887,291,416,95,1138,980,158,13,23,3,27-1000,Art and Design Workers
24,Maryland,272,14174,12668,1506,187,186,89,981,893,88,9,6,7,27-2000,"Entertainers and Performers, Sports and Related Workers"
24,Maryland,273,24002,21113,2889,208,421,113,1481,1301,180,13,23,6,27-3000,Media and Communication Workers
24,Maryland,274,6678,5995,683,124,82,17,416,374,42,5,3,1,27-4000,Media and Communication Equipment Workers
24,Maryland,291,125292,92312,32980,457,1345,380,6819,5220,1599,24,60,14,29-1000,Healthcare Diagnosing or Treating Practitioners
24,Maryland,292,50603,39679,10924,428,323,104,2566,2054,512,19,20,8,29-2000,Health Technologists and Technicians
24,Maryland,299,2180,1880,300,27,20,0,142,121,21,2,1,0,29-9000,Other Healthcare Practitioners and Technical Occupations
24,Maryland,3111,53851,34484,19367,725,502,274,2397,1602,795,29,31,7,31-1100,"Home Health and Personal Care Aides; and Nursing Assistants, Orderlies, and Psychiatric Aides"
24,Maryland,312,2697,2416,281,42,52,7,152,137,15,3,2,1,31-2000,Occupational Therapy and Physical Therapist Assistants and Aides
24,Maryland,319,26643,21495,5148,1276,584,72,1288,1068,220,45,23,5,31-9000,Other Healthcare Support Occupations
24,Maryland,331,6943,6334,609,80,105,0,397,368,29,2,3,0,33-1000,Supervisors of Protective Service Workers
24,Maryland,332,6847,6718,129,8,0,17,374,365,9,2,0,1,33-2000,Firefighting and Prevention Workers
24,Maryland,333,34271,31232,3039,126,339,0,1738,1609,129,4,10,0,33-3000,Law Enforcement Workers
24,Maryland,339,36101,31206,4895,489,171,14,2120,1898,222,15,11,1,33-9000,Other Protective Service Workers
24,Maryland,351,18964,12674,6290,1058,576,529,908,643,265,46,19,19,35-1000,Supervisors of Food Preparation and Serving Workers
24,Maryland,352,52322,33455,18867,10029,942,1269,2770,2020,750,346,44,46,35-2000,Cooks and Food Preparation Workers
24,Maryland,353,57349,47121,10228,2613,785,706,3374,2851,523,105,43,28,35-3000,Food and Beverage Serving Workers
24,Maryland,359,17758,14212,3546,1631,105,382,1180,1010,170,56,6,15,35-9000,Other Food Preparation and Serving Related Workers
24,Maryland,371,8762,6219,2543,1552,198,238,406,306,100,54,10,6,37-1000,Supervisors of Building and Grounds Cleaning and Maintenance Workers
24,Maryland,372,72721,41699,31022,16809,3742,3111,3637,2332,1305,686,143,134,37-2000,Building Cleaning and Pest Control Workers
24,Maryland,373,20949,11707,9242,6853,306,1504,1050,783,267,172,10,53,37-3000,Grounds Maintenance Workers
24,Maryland,391,2058,1597,461,0,0,0,110,90,20,0,0,0,39-1000,Supervisors of Personal Care and Service Workers
24,Maryland,392,6125,5494,631,48,234,49,388,354,34,4,9,2,39-2000,Animal Care and Service Workers
24,Maryland,393,5501,4955,546,57,10,3,428,394,34,4,1,1,39-3000,Entertainment Attendants and Related Workers
24,Maryland,394,724,694,30,20,0,10,44,42,2,1,0,1,39-4000,Funeral Service Workers
24,Maryland,395,24623,16649,7974,844,511,296,1164,809,355,29,22,9,39-5000,Personal Appearance Workers
24,Maryland,396,1697,1365,332,18,61,0,75,64,11,1,2,0,39-6000,"Baggage Porters, Bellhops, and Concierges"
24,Maryland,397,998,885,113,27,30,17,86,78,8,1,1,1,39-7000,Tour and Travel Guides
24,Maryland,399,43394,32438,10956,2262,2105,307,2923,2339,584,103,100,20,39-9000,Other Personal Care and Service Workers
24,Maryland,411,66407,55832,10575,1057,741,170,3587,3061,526,49,39,10,41-1000,Supervisors of Sales Workers
24,Maryland,412,114629,91542,23087,4098,1280,737,7002,5831,1171,173,77,30,41-2000,Retail Sales Workers
24,Maryland,413,26916,24301,2615,503,286,86,1489,1350,139,19,17,4,41-3000,"Sales Representatives, Services"
24,Maryland,414,16938,15549,1389,203,96,92,984,912,72,8,7,3,41-4000,"Sales Representatives, Wholesale and Manufacturing"
24,Maryland,419,22079,19662,2417,345,139,12,1307,1161,146,17,10,3,41-9000,Other Sales and Related Workers
24,Maryland,431,32983,29155,3828,345,616,102,1841,1652,189,13,28,3,43-1000,Supervisors of Office and Administrative Support Workers
24,Maryland,432,1719,1495,224,52,15,0,94,85,9,1,1,0,43-2000,Communications Equipment Operators
24,Maryland,433,41747,36344,5403,844,334,129,2420,2118,302,38,22,5,43-3000,Financial Clerks
24,Maryland,434,87837,76863,10974,1625,1339,416,4893,4341,552,73,54,15,43-4000,Information and Record Clerks
24,Maryland,435,32862,27939,4923,703,208,13,1700,1481,219,32,11,2,43-5000,"Material Recording, Scheduling, Dispatching, and Distributing Workers"
24,Maryland,436,63230,56090,7140,972,911,196,3860,3456,404,50,53,14,43-6000,Secretaries and Administrative Assistants
24,Maryland,439,58810,51245,7565,1421,602,277,3458,3079,379,49,40,13,43-9000,Other Office and Administrative Support Workers
24,Maryland,451,209,191,18,4,0,0,11,9,2,1,0,0,45-1000,"Supervisors of Farming, Fishing, and Forestry Workers"
24,Maryland,452,3901,2813,1088,435,0,379,295,228,67,23,0,32,45-2000,Agricultural Workers
24,Maryland,453,954,947,7,0,0,0,58,57,1,0,0,0,45-3000,Fishing and Hunting Workers
24,Maryland,454,550,412,138,126,0,12,31,26,5,4,0,1,45-4000,"Forest, Conservation, and Logging Workers"
24,Maryland,471,16397,12593,3804,2257,375,512,848,702,146,76,16,17,47-1000,Supervisors of Construction and Extraction Workers
24,Maryland,472,117993,68317,49676,34788,4073,5962,5445,3833,1612,1040,135,191,47-2000,Construction Trades Workers
24,Maryland,473,1115,865,250,155,0,78,60,50,10,5,0,3,47-3000,"Helpers, Construction Trades"
24,Maryland,474,7274,6133,1141,739,34,41,352,310,42,18,2,2,47-4000,Other Construction and Related Workers
24,Maryland,475,1263,1142,121,104,17,0,51,48,3,2,1,0,47-5000,Extraction Workers
24,Maryland,491,3495,3055,440,13,108,39,207,193,14,1,3,1,49-1000,"Supervisors of Installation, Maintenance, and Repair Workers"
24,Maryland,492,10435,9183,1252,189,113,0,535,473,62,9,7,1,49-2000,"Electrical and Electronic Equipment Mechanics, Installers, and Repairers"
24,Maryland,493,30267,24015,6252,2133,630,245,1528,1282,246,70,27,8,49-3000,"Vehicle and Mobile Equipment Mechanics, Installers, and Repairers"
24,Maryland,499,37332,31359,5973,1766,518,606,1851,1629,222,60,20,17,49-9000,"Other Installation, Maintenance, and Repair Occupations"
24,Maryland,511,7767,6600,1167,252,0,41,421,372,49,10,0,1,51-1000,Supervisors of Production Workers
24,Maryland,512,6265,4867,1398,397,20,159,371,303,68,11,3,5,51-2000,Assemblers and Fabricators
24,Maryland,513,9829,7306,2523,906,146,79,459,355,104,40,6,3,51-3000,Food Processing Workers
24,Maryland,514,8595,7126,1469,364,92,230,485,428,57,14,6,5,51-4000,Metal Workers and Plastic Workers
24,Maryland,5151,3650,3052,598,79,32,200,233,203,30,3,3,5,51-5100,Printing Workers
24,Maryland,516,7099,3601,3498,1168,185,549,362,217,145,44,6,19,51-6000,"Textile, Apparel, and Furnishings Workers"
24,Maryland,517,1158,1007,151,79,43,0,88,80,8,3,2,0,51-7000,Woodworkers
24,Maryland,518,5869,4902,967,281,0,0,298,259,39,12,0,0,51-8000,Plant and System Operators
24,Maryland,519,29089,22871,6218,1422,381,676,1548,1269,279,55,18,25,51-9000,Other Production Occupations
24,Maryland,531,4449,3554,895,68,69,53,220,187,33,2,3,2,53-1000,Supervisors of Transportation and Material Moving Workers
24,Maryland,532,4308,3951,357,0,29,0,224,200,24,0,2,0,53-2000,Air Transportation Workers
24,Maryland,533,81177,61700,19477,4984,1549,467,3861,3083,778,183,55,24,53-3000,Motor Vehicle Operators
24,Maryland,534,1301,1152,149,0,0,0,80,74,6,0,0,0,53-4000,Rail Transportation Workers
24,Maryland,535,652,565,87,17,0,0,53,47,6,1,0,0,53-5000,Water Transportation Workers
24,Maryland,536,5484,3481,2003,199,119,94,261,196,65,8,5,4,53-6000,Other Transportation Workers
24,Maryland,537,79453,67372,12081,3725,842,509,4479,3946,533,144,31,34,53-7000,Material Moving Workers
25,Massachusetts,111,54729,47170,7559,58,555,262,3155,2745,410,3,25,9,11-1000,Top Executives
25,Massachusetts,112,33367,29668,3699,212,494,57,1930,1719,211,5,23,3,11-2000,"Advertising, Marketing, Promotions, Public Relations, and Sales Managers"
25,Massachusetts,113,83469,69767,13702,433,1305,109,4681,3963,718,20,65,6,11-3000,Operations Specialties Managers
25,Massachusetts,119,219698,182236,37462,1896,4423,675,12261,10423,1838,75,176,30,11-9000,Other Management Occupations
25,Massachusetts,131,130476,111974,18502,548,1958,238,7674,6620,1054,23,104,14,13-1000,Business Operations Specialists
25,Massachusetts,132,90361,74254,16107,340,1330,61,5142,4321,821,19,64,5,13-2000,Financial Specialists
25,Massachusetts,1512,142439,101058,41381,469,1946,281,8087,5957,2130,22,106,12,15-1200,Computer Occupations
25,Massachusetts,152,9384,6599,2785,13,34,0,552,387,165,1,4,0,15-2000,Mathematical Science Occupations
25,Massachusetts,171,7591,5892,1699,9,213,0,469,365,104,1,13,0,17-1000,"Architects, Surveyors, and Cartographers"
25,Massachusetts,172,59705,46166,13539,315,670,157,3373,2652,721,13,31,6,17-2000,Engineers
25,Massachusetts,173,12604,10115,2489,64,131,0,760,634,126,2,10,0,17-3000,"Drafters, Engineering Technicians, and Mapping Technicians"
25,Massachusetts,191,18110,9331,8779,41,458,64,1042,543,499,2,20,3,19-1000,Life Scientists
25,Massachusetts,192,25069,13900,11169,255,538,88,1468,833,635,5,27,5,19-2000,Physical Scientists
25,Massachusetts,193,10008,8572,1436,27,325,22,635,544,91,1,14,1,19-3000,Social Scientists and Related Workers
25,Massachusetts,194,13618,10420,3198,168,177,0,1010,790,220,7,11,1,19-4000,"Life, Physical, and Social Science Technicians"
25,Massachusetts,195,1054,968,86,0,11,0,65,61,4,0,1,0,19-5000,Occupational Health and Safety Specialists and Technicians
25,Massachusetts,211,64120,55043,9077,218,860,148,3490,3071,419,14,44,9,21-1000,"Counselors, Social Workers, and Other Community and Social Service Specialists"
25,Massachusetts,212,6675,5587,1088,0,143,14,478,391,87,1,12,10,21-2000,Religious Workers
25,Massachusetts,231,31647,28963,2684,16,351,0,1917,1761,156,1,17,0,23-1000,"Lawyers, Judges, and Related Workers"
25,Massachusetts,232,10914,9543,1371,124,268,16,666,584,82,3,11,2,23-2000,Legal Support Workers
25,Massachusetts,251,49277,34023,15254,261,1259,172,3240,2300,940,12,68,12,25-1000,Postsecondary Teachers
25,Massachusetts,252,128800,118369,10431,194,1799,205,7692,7095,597,12,76,12,25-2000,"Preschool, Elementary, Middle, Secondary, and Special Education Teachers"
25,Massachusetts,253,22118,18188,3930,111,354,66,1697,1408,289,3,22,3,25-3000,Other Teachers and Instructors
25,Massachusetts,254,8437,7763,674,0,57,0,580,537,43,0,5,0,25-4000,"Librarians, Curators, and Archivists"
25,Massachusetts,259,33420,28640,4780,291,601,113,2179,1860,319,10,43,6,25-9000,Other Educational Instruction and Library Occupations
25,Massachusetts,271,26738,22902,3836,195,252,39,1647,1425,222,10,19,4,27-1000,Art and Design Workers
25,Massachusetts,272,17312,15241,2071,63,155,68,1316,1157,159,5,8,2,27-2000,"Entertainers and Performers, Sports and Related Workers"
25,Massachusetts,273,24847,21584,3263,86,484,50,1637,1425,212,4,27,3,27-3000,Media and Communication Workers
25,Massachusetts,274,6222,5856,366,0,102,0,442,411,31,1,6,0,27-4000,Media and Communication Equipment Workers
25,Massachusetts,291,165426,136292,29134,550,2279,111,9079,7620,1459,22,103,8,29-1000,Healthcare Diagnosing or Treating Practitioners
25,Massachusetts,292,59805,48140,11665,583,890,0,3159,2646,513,19,40,0,29-2000,Health Technologists and Technicians
25,Massachusetts,299,2160,2012,148,0,14,0,124,112,12,0,2,0,29-9000,Other Healthcare Practitioners and Technical Occupations
25,Massachusetts,3111,86472,53653,32819,1062,1997,28,4179,2862,1317,53,86,3,31-1100,"Home Health and Personal Care Aides; and Nursing Assistants, Orderlies, and Psychiatric Aides"
25,Massachusetts,312,2674,2348,326,58,117,0,162,151,11,1,2,0,31-2000,Occupational Therapy and Physical Therapist Assistants and Aides
25,Massachusetts,319,32801,25806,6995,454,1013,68,1696,1389,307,18,35,3,31-9000,Other Healthcare Support Occupations
25,Massachusetts,331,5850,5741,109,0,0,0,349,339,10,0,0,0,33-1000,Supervisors of Protective Service Workers
25,Massachusetts,332,10765,10192,573,166,87,0,579,554,25,5,5,0,33-2000,Firefighting and Prevention Workers
25,Massachusetts,333,26384,24614,1770,190,242,21,1358,1272,86,7,9,1,33-3000,Law Enforcement Workers
25,Massachusetts,339,25747,22033,3714,268,147,48,1707,1513,194,12,15,2,33-9000,Other Protective Service Workers
25,Massachusetts,351,22264,15450,6814,517,1084,146,1100,814,286,20,38,5,35-1000,Supervisors of Food Preparation and Serving Workers
25,Massachusetts,352,68714,41130,27584,6974,5381,1034,3675,2567,1108,215,187,29,35-2000,Cooks and Food Preparation Workers
25,Massachusetts,353,77358,63541,13817,1818,2792,322,4593,3896,697,61,109,8,35-3000,Food and Beverage Serving Workers
25,Massachusetts,359,22708,17404,5304,996,1011,182,1689,1444,245,32,36,5,35-9000,Other Food Preparation and Serving Related Workers
25,Massachusetts,371,7395,5573,1822,248,830,124,381,298,83,10,34,4,37-1000,Supervisors of Building and Grounds Cleaning and Maintenance Workers
25,Massachusetts,372,79565,37997,41568,7970,15265,583,3984,2392,1592,259,492,24,37-2000,Building Cleaning and Pest Control Workers
25,Massachusetts,373,23518,17680,5838,2110,1299,196,1557,1332,225,72,45,6,37-3000,Grounds Maintenance Workers
25,Massachusetts,391,1716,1419,297,0,66,0,96,81,15,0,3,0,39-1000,Supervisors of Personal Care and Service Workers
25,Massachusetts,392,6707,5979,728,44,139,15,458,420,38,3,7,1,39-2000,Animal Care and Service Workers
25,Massachusetts,393,6307,5589,718,73,26,29,552,508,44,3,4,1,39-3000,Entertainment Attendants and Related Workers
25,Massachusetts,394,947,885,62,0,0,0,67,62,5,0,0,0,39-4000,Funeral Service Workers
25,Massachusetts,395,29998,20431,9567,262,1426,85,1408,1025,383,9,46,5,39-5000,Personal Appearance Workers
25,Massachusetts,396,1456,1132,324,0,0,0,84,69,15,1,0,0,39-6000,"Baggage Porters, Bellhops, and Concierges"
25,Massachusetts,397,2152,1994,158,0,15,0,182,161,21,0,1,0,39-7000,Tour and Travel Guides
25,Massachusetts,399,53312,42668,10644,640,2490,330,4017,3455,562,29,116,13,39-9000,Other Personal Care and Service Workers
25,Massachusetts,411,88188,74905,13283,946,1429,102,4794,4143,651,37,65,6,41-1000,Supervisors of Sales Workers
25,Massachusetts,412,130672,106747,23925,2400,2385,350,8550,7369,1181,76,108,15,41-2000,Retail Sales Workers
25,Massachusetts,413,39946,36546,3400,18,401,57,2258,2066,192,2,18,3,41-3000,"Sales Representatives, Services"
25,Massachusetts,414,27346,25488,1858,71,169,23,1512,1403,109,4,11,1,41-4000,"Sales Representatives, Wholesale and Manufacturing"
25,Massachusetts,419,25443,21582,3861,81,323,31,1556,1364,192,4,15,2,41-9000,Other Sales and Related Workers
25,Massachusetts,431,26790,23301,3489,162,487,19,1509,1322,187,6,27,1,43-1000,Supervisors of Office and Administrative Support Workers
25,Massachusetts,432,1764,1490,274,0,20,0,109,93,16,0,2,0,43-2000,Communications Equipment Operators
25,Massachusetts,433,48622,41004,7618,470,763,16,2890,2464,426,17,36,3,43-3000,Financial Clerks
25,Massachusetts,434,101347,87011,14336,1157,1573,194,6211,5431,780,53,68,10,43-4000,Information and Record Clerks
25,Massachusetts,435,42917,35862,7055,824,693,118,2418,2113,305,31,26,3,43-5000,"Material Recording, Scheduling, Dispatching, and Distributing Workers"
25,Massachusetts,436,64017,57262,6755,451,1029,54,3980,3596,384,20,49,2,43-6000,Secretaries and Administrative Assistants
25,Massachusetts,439,59518,51386,8132,349,748,194,3824,3299,525,17,40,20,43-9000,Other Office and Administrative Support Workers
25,Massachusetts,451,322,297,25,0,25,0,23,22,1,0,1,0,45-1000,"Supervisors of Farming, Fishing, and Forestry Workers"
25,Massachusetts,452,4570,3149,1421,669,121,56,343,281,62,25,5,3,45-2000,Agricultural Workers
25,Massachusetts,453,1974,1594,380,40,0,91,109,91,18,2,0,2,45-3000,Fishing and Hunting Workers
25,Massachusetts,454,736,709,27,0,0,0,71,70,1,0,0,0,45-4000,"Forest, Conservation, and Logging Workers"
25,Massachusetts,471,13739,11828,1911,46,253,0,719,630,89,3,14,0,47-1000,Supervisors of Construction and Extraction Workers
25,Massachusetts,472,130341,93806,36535,6603,14632,974,6687,5397,1290,177,412,30,47-2000,Construction Trades Workers
25,Massachusetts,473,716,575,141,13,0,0,44,35,9,1,1,0,47-3000,"Helpers, Construction Trades"
25,Massachusetts,474,5701,4865,836,221,39,0,338,295,43,9,3,0,47-4000,Other Construction and Related Workers
25,Massachusetts,475,1003,782,221,31,0,0,55,51,4,1,0,0,47-5000,Extraction Workers
25,Massachusetts,491,3478,3012,466,150,115,18,190,172,18,4,4,1,49-1000,"Supervisors of Installation, Maintenance, and Repair Workers"
25,Massachusetts,492,8389,7390,999,98,45,0,470,415,55,4,4,0,49-2000,"Electrical and Electronic Equipment Mechanics, Installers, and Repairers"
25,Massachusetts,493,27425,22880,4545,533,883,0,1376,1188,188,16,30,0,49-3000,"Vehicle and Mobile Equipment Mechanics, Installers, and Repairers"
25,Massachusetts,499,32998,28536,4462,347,623,55,1816,1622,194,14,22,3,49-9000,"Other Installation, Maintenance, and Repair Occupations"
25,Massachusetts,511,11570,8757,2813,153,109,26,679,548,131,11,6,1,51-1000,Supervisors of Production Workers
25,Massachusetts,512,18168,10629,7539,447,433,169,934,568,366,20,20,4,51-2000,Assemblers and Fabricators
25,Massachusetts,513,13240,8570,4670,1272,372,35,658,476,182,36,15,1,51-3000,Food Processing Workers
25,Massachusetts,514,24855,18662,6193,542,546,145,1265,997,268,18,17,4,51-4000,Metal Workers and Plastic Workers
25,Massachusetts,5151,4868,3814,1054,121,75,0,255,205,50,3,3,0,51-5100,Printing Workers
25,Massachusetts,516,8291,3203,5088,958,381,139,472,228,244,38,19,5,51-6000,"Textile, Apparel, and Furnishings Workers"
25,Massachusetts,517,1983,1719,264,46,48,0,119,110,9,1,1,1,51-7000,Woodworkers
25,Massachusetts,518,4334,3873,461,0,74,0,256,232,24,0,3,0,51-8000,Plant and System Operators
25,Massachusetts,519,46811,32139,14672,1999,1185,267,2545,1851,694,62,54,6,51-9000,Other Production Occupations
25,Massachusetts,531,3553,3095,458,125,43,34,182,162,20,5,2,1,53-1000,Supervisors of Transportation and Material Moving Workers
25,Massachusetts,532,3459,2940,519,0,67,12,183,159,24,0,4,1,53-2000,Air Transportation Workers
25,Massachusetts,533,79727,55517,24210,2562,4166,147,3992,3080,912,81,137,6,53-3000,Motor Vehicle Operators
25,Massachusetts,534,1667,1391,276,0,0,0,87,78,9,0,0,0,53-4000,Rail Transportation Workers
25,Massachusetts,535,1281,1064,217,51,0,0,65,60,5,1,0,0,53-5000,Water Transportation Workers
25,Massachusetts,536,5818,4532,1286,177,164,15,339,274,65,6,6,1,53-6000,Other Transportation Workers
25,Massachusetts,537,85167,64755,20412,3822,2161,222,4908,4025,883,144,86,12,53-7000,Material Moving Workers
26,Michigan,111,54245,50136,4109,101,88,128,2869,2688,181,2,5,3,11-1000,Top Executives
26,Michigan,112,29693,28103,1590,0,84,46,1479,1388,91,1,5,5,11-2000,"Advertising, Marketing, Promotions, Public Relations, and Sales Managers"
26,Michigan,113,84320,77528,6792,13,542,555,4490,4168,322,1,25,16,11-3000,Operations Specialties Managers
26,Michigan,119,242173,221337,20836,273,535,1526,13384,12491,893,8,32,55,11-9000,Other Management Occupations
26,Michigan,131,126427,116912,9515,148,340,630,6626,6191,435,5,20,28,13-1000,Business Operations Specialists
26,Michigan,132,86139,79797,6342,0,233,267,4629,4326,303,0,16,20,13-2000,Financial Specialists
26,Michigan,1512,110770,89101,21669,17,300,900,5496,4594,902,1,15,35,15-1200,Computer Occupations
26,Michigan,152,7004,5841,1163,13,0,25,363,314,49,1,0,1,15-2000,Mathematical Science Occupations
26,Michigan,171,4401,3946,455,0,0,0,246,221,25,0,1,0,17-1000,"Architects, Surveyors, and Cartographers"
26,Michigan,172,107611,85445,22166,160,893,1275,5345,4413,932,7,41,51,17-2000,Engineers
26,Michigan,173,22511,20672,1839,0,28,49,1228,1150,78,0,3,4,17-3000,"Drafters, Engineering Technicians, and Mapping Technicians"
26,Michigan,191,6034,4543,1491,0,56,19,334,267,67,0,2,2,19-1000,Life Scientists
26,Michigan,192,10470,8084,2386,0,51,79,519,408,111,0,2,3,19-2000,Physical Scientists
26,Michigan,193,5722,5357,365,23,0,0,316,291,25,1,2,0,19-3000,Social Scientists and Related Workers
26,Michigan,194,11698,10676,1022,50,32,101,709,651,58,3,4,6,19-4000,"Life, Physical, and Social Science Technicians"
26,Michigan,195,1915,1793,122,0,0,0,80,74,6,0,0,0,19-5000,Occupational Health and Safety Specialists and Technicians
26,Michigan,211,55997,53652,2345,116,45,188,2937,2826,111,4,4,8,21-1000,"Counselors, Social Workers, and Other Community and Social Service Specialists"
26,Michigan,212,15074,14099,975,31,64,227,938,875,63,2,7,8,21-2000,Religious Workers
26,Michigan,231,22797,21721,1076,0,57,54,1175,1124,51,0,3,3,23-1000,"Lawyers, Judges, and Related Workers"
26,Michigan,232,11401,10628,773,0,0,0,595,565,30,0,2,1,23-2000,Legal Support Workers
26,Michigan,251,41999,31171,10828,106,388,235,2254,1739,515,5,22,11,25-1000,Postsecondary Teachers
26,Michigan,252,126339,120929,5410,71,168,464,7588,7298,290,3,8,15,25-2000,"Preschool, Elementary, Middle, Secondary, and Special Education Teachers"
26,Michigan,253,22173,20286,1887,81,41,313,1334,1236,98,2,3,15,25-3000,Other Teachers and Instructors
26,Michigan,254,6815,6371,444,0,8,0,421,405,16,0,1,1,25-4000,"Librarians, Curators, and Archivists"
26,Michigan,259,34678,31866,2812,81,126,258,2372,2195,177,10,9,15,25-9000,Other Educational Instruction and Library Occupations
26,Michigan,271,31186,28214,2972,0,98,319,1716,1585,131,0,4,17,27-1000,Art and Design Workers
26,Michigan,272,15953,14920,1033,0,30,15,1089,1024,65,0,2,2,27-2000,"Entertainers and Performers, Sports and Related Workers"
26,Michigan,273,17954,16654,1300,92,106,191,1008,922,86,4,5,9,27-3000,Media and Communication Workers
26,Michigan,274,7650,7178,472,0,0,0,437,415,22,0,0,0,27-4000,Media and Communication Equipment Workers
26,Michigan,291,195961,172545,23416,144,602,106,10448,9436,1012,5,32,8,29-1000,Healthcare Diagnosing or Treating Practitioners
26,Michigan,292,83342,77806,5536,79,279,247,4563,4333,230,4,12,6,29-2000,Health Technologists and Technicians
26,Michigan,299,2763,2692,71,0,0,0,144,138,6,0,0,0,29-9000,Other Healthcare Practitioners and Technical Occupations
26,Michigan,3111,104761,98132,6629,58,56,382,5730,5419,311,3,6,18,31-1100,"Home Health and Personal Care Aides; and Nursing Assistants, Orderlies, and Psychiatric Aides"
26,Michigan,312,5275,4944,331,0,0,0,291,278,13,0,1,0,31-2000,Occupational Therapy and Physical Therapist Assistants and Aides
26,Michigan,319,51576,48428,3148,93,86,337,2778,2636,142,5,8,13,31-9000,Other Healthcare Support Occupations
26,Michigan,331,6434,6225,209,0,0,0,391,385,6,0,0,0,33-1000,Supervisors of Protective Service Workers
26,Michigan,332,5723,5692,31,0,0,0,332,329,3,0,0,0,33-2000,Firefighting and Prevention Workers
26,Michigan,333,31520,30770,750,0,65,126,1820,1783,37,0,1,5,33-3000,Law Enforcement Workers
26,Michigan,339,29290,28350,940,6,42,17,1692,1636,56,3,2,2,33-9000,Other Protective Service Workers
26,Michigan,351,29585,26433,3152,77,14,226,1434,1328,106,3,2,8,35-1000,Supervisors of Food Preparation and Serving Workers
26,Michigan,352,105592,95469,10123,480,243,3168,6157,5746,411,14,12,85,35-2000,Cooks and Food Preparation Workers
26,Michigan,353,111685,104955,6730,74,303,874,6356,6063,293,3,12,28,35-3000,Food and Beverage Serving Workers
26,Michigan,359,31052,27595,3457,270,34,824,2149,2013,136,10,2,22,35-9000,Other Food Preparation and Serving Related Workers
26,Michigan,371,12841,12367,474,10,27,130,674,652,22,1,1,5,37-1000,Supervisors of Building and Grounds Cleaning and Maintenance Workers
26,Michigan,372,112761,103232,9529,570,148,1643,7060,6659,401,16,7,78,37-2000,Building Cleaning and Pest Control Workers
26,Michigan,373,34464,30954,3510,334,0,2287,2662,2526,136,13,0,73,37-3000,Grounds Maintenance Workers
26,Michigan,391,4062,3625,437,0,41,61,219,202,17,0,1,2,39-1000,Supervisors of Personal Care and Service Workers
26,Michigan,392,8814,8503,311,0,29,0,525,507,18,0,1,0,39-2000,Animal Care and Service Workers
26,Michigan,393,10670,10125,545,36,0,0,731,705,26,1,1,2,39-3000,Entertainment Attendants and Related Workers
26,Michigan,394,1680,1675,5,0,0,0,85,84,1,0,0,0,39-4000,Funeral Service Workers
26,Michigan,395,35321,30403,4918,0,13,48,1798,1614,184,1,1,3,39-5000,Personal Appearance Workers
26,Michigan,396,1299,1217,82,0,0,0,57,53,4,0,0,0,39-6000,"Baggage Porters, Bellhops, and Concierges"
26,Michigan,397,1159,1126,33,0,0,0,110,109,1,0,0,0,39-7000,Tour and Travel Guides
26,Michigan,399,51282,48547,2735,0,158,354,3481,3313,168,1,9,15,39-9000,Other Personal Care and Service Workers
26,Michigan,411,116288,107636,8652,34,141,408,6339,5964,375,2,9,12,41-1000,Supervisors of Sales Workers
26,Michigan,412,190425,177156,13269,268,110,852,11587,10965,622,14,5,36,41-2000,Retail Sales Workers
26,Michigan,413,38447,36689,1758,0,104,42,2026,1940,86,0,3,2,41-3000,"Sales Representatives, Services"
26,Michigan,414,40974,39030,1944,150,44,73,2192,2091,101,1,2,5,41-4000,"Sales Representatives, Wholesale and Manufacturing"
26,Michigan,419,35506,33392,2114,0,129,180,1961,1871,90,0,4,6,41-9000,Other Sales and Related Workers
26,Michigan,431,33158,31524,1634,0,0,78,1760,1696,64,0,1,4,43-1000,Supervisors of Office and Administrative Support Workers
26,Michigan,432,1539,1498,41,0,0,0,89,87,2,0,0,0,43-2000,Communications Equipment Operators
26,Michigan,433,65422,62085,3337,139,114,308,3964,3798,166,5,7,10,43-3000,Financial Clerks
26,Michigan,434,148411,141573,6838,227,240,630,8295,7970,325,7,16,25,43-4000,Information and Record Clerks
26,Michigan,435,66640,63511,3129,0,86,583,3708,3585,123,1,4,20,43-5000,"Material Recording, Scheduling, Dispatching, and Distributing Workers"
26,Michigan,436,89605,86401,3204,18,164,338,5767,5577,190,1,12,15,43-6000,Secretaries and Administrative Assistants
26,Michigan,439,80211,76450,3761,9,167,312,4850,4642,208,3,10,12,43-9000,Other Office and Administrative Support Workers
26,Michigan,451,1153,976,177,0,0,132,80,70,10,0,0,8,45-1000,"Supervisors of Farming, Fishing, and Forestry Workers"
26,Michigan,452,21864,15413,6451,441,0,5638,1875,1536,339,23,2,288,45-2000,Agricultural Workers
26,Michigan,453,226,226,0,0,0,0,30,30,0,0,0,0,45-3000,Fishing and Hunting Workers
26,Michigan,454,2559,2221,338,151,0,125,249,240,9,2,0,4,45-4000,"Forest, Conservation, and Logging Workers"
26,Michigan,471,17832,17242,590,46,0,252,1177,1151,26,1,0,9,47-1000,Supervisors of Construction and Extraction Workers
26,Michigan,472,163417,149478,13939,795,275,7861,10227,9713,514,29,11,228,47-2000,Construction Trades Workers
26,Michigan,473,500,464,36,0,0,36,30,28,2,0,0,2,47-3000,"Helpers, Construction Trades"
26,Michigan,474,7103,6945,158,0,10,115,475,469,6,0,1,2,47-4000,Other Construction and Related Workers
26,Michigan,475,2573,2539,34,0,0,0,200,197,3,0,0,0,47-5000,Extraction Workers
26,Michigan,491,7519,7318,201,0,0,26,431,420,11,0,0,1,49-1000,"Supervisors of Installation, Maintenance, and Repair Workers"
26,Michigan,492,13263,12880,383,0,0,0,721,700,21,1,0,1,49-2000,"Electrical and Electronic Equipment Mechanics, Installers, and Repairers"
26,Michigan,493,52675,49978,2697,0,98,334,3174,3063,111,0,5,15,49-3000,"Vehicle and Mobile Equipment Mechanics, Installers, and Repairers"
26,Michigan,499,65277,62337,2940,83,60,682,3936,3809,127,3,1,28,49-9000,"Other Installation, Maintenance, and Repair Occupations"
26,Michigan,511,41574,39255,2319,26,40,570,2252,2141,111,2,2,23,51-1000,Supervisors of Production Workers
26,Michigan,512,93982,86734,7248,238,101,1434,4805,4528,277,7,4,51,51-2000,Assemblers and Fabricators
26,Michigan,513,17347,14185,3162,277,0,1120,1051,944,107,10,1,28,51-3000,Food Processing Workers
26,Michigan,514,103480,96147,7333,173,16,1695,5996,5685,311,7,2,60,51-4000,Metal Workers and Plastic Workers
26,Michigan,5151,6124,5815,309,0,15,67,349,338,11,0,2,2,51-5100,Printing Workers
26,Michigan,516,13944,11430,2514,23,82,504,837,745,92,1,1,15,51-6000,"Textile, Apparel, and Furnishings Workers"
26,Michigan,517,4813,4545,268,77,0,114,338,327,11,2,0,5,51-7000,Woodworkers
26,Michigan,518,7835,7760,75,0,4,0,490,485,5,0,1,0,51-8000,Plant and System Operators
26,Michigan,519,137592,124144,13448,553,138,4216,7867,7360,507,16,8,134,51-9000,Other Production Occupations
26,Michigan,531,6445,5952,493,0,0,56,323,307,16,0,0,3,53-1000,Supervisors of Transportation and Material Moving Workers
26,Michigan,532,5519,5112,407,0,43,0,278,260,18,0,2,0,53-2000,Air Transportation Workers
26,Michigan,533,126211,115780,10431,90,190,858,7256,6859,397,4,5,39,53-3000,Motor Vehicle Operators
26,Michigan,534,1798,1772,26,0,0,12,114,111,3,0,0,1,53-4000,Rail Transportation Workers
26,Michigan,535,843,843,0,0,0,0,97,97,0,0,0,0,53-5000,Water Transportation Workers
26,Michigan,536,8231,7589,642,0,66,38,499,469,30,0,2,1,53-6000,Other Transportation Workers
26,Michigan,537,178393,163802,14591,1069,214,4053,10799,10237,562,36,8,161,53-7000,Material Moving Workers
27,Minnesota,111,39267,37000,2267,0,153,217,1875,1812,63,0,3,3,11-1000,Top Executives
27,Minnesota,112,24209,23073,1136,0,186,75,989,955,34,0,5,2,11-2000,"Advertising, Marketing, Promotions, Public Relations, and Sales Managers"
27,Minnesota,113,65092,59337,5755,104,374,298,2961,2802,159,4,8,8,11-3000,Operations Specialties Managers
27,Minnesota,119,169740,158555,11185,255,570,1532,10511,10155,356,10,17,42,11-9000,Other Management Occupations
27,Minnesota,131,102641,96062,6579,120,345,302,4547,4338,209,3,12,9,13-1000,Business Operations Specialists
27,Minnesota,132,68482,63400,5082,42,287,102,3267,3104,163,1,7,9,13-2000,Financial Specialists
27,Minnesota,1512,101170,81399,19771,151,375,364,3944,3427,517,6,14,12,15-1200,Computer Occupations
27,Minnesota,152,5784,5051,733,0,0,16,236,214,22,0,1,2,15-2000,Mathematical Science Occupations
27,Minnesota,171,4528,4088,440,0,60,21,170,157,13,0,2,1,17-1000,"Architects, Surveyors, and Cartographers"
27,Minnesota,172,40474,35958,4516,0,77,254,1696,1584,112,1,3,6,17-2000,Engineers
27,Minnesota,173,14492,13023,1469,52,38,69,794,754,40,1,1,2,17-3000,"Drafters, Engineering Technicians, and Mapping Technicians"
27,Minnesota,191,6647,5254,1393,0,110,44,349,301,48,0,4,2,19-1000,Life Scientists
27,Minnesota,192,9017,7430,1587,32,0,49,337,287,50,1,0,2,19-2000,Physical Scientists
27,Minnesota,193,6548,6145,403,0,0,0,253,242,11,0,0,0,19-3000,Social Scientists and Related Workers
27,Minnesota,194,6538,5927,611,0,26,17,416,390,26,0,1,2,19-4000,"Life, Physical, and Social Science Technicians"
27,Minnesota,195,1632,1632,0,0,0,0,60,60,0,0,0,0,19-5000,Occupational Health and Safety Specialists and Technicians
27,Minnesota,211,48063,44620,3443,100,68,385,2381,2275,106,5,3,11,21-1000,"Counselors, Social Workers, and Other Community and Social Service Specialists"
27,Minnesota,212,10958,10206,752,0,57,132,582,558,24,0,2,3,21-2000,Religious Workers
27,Minnesota,231,17177,16024,1153,0,37,28,689,660,29,0,1,1,23-1000,"Lawyers, Judges, and Related Workers"
27,Minnesota,232,8039,7709,330,0,0,11,395,384,11,0,0,1,23-2000,Legal Support Workers
27,Minnesota,251,22333,18189,4144,48,286,149,1124,966,158,1,8,8,25-1000,Postsecondary Teachers
27,Minnesota,252,94793,90871,3922,43,493,185,5070,4913,157,3,18,7,25-2000,"Preschool, Elementary, Middle, Secondary, and Special Education Teachers"
27,Minnesota,253,15623,14144,1479,68,0,177,813,743,70,2,0,5,25-3000,Other Teachers and Instructors
27,Minnesota,254,3846,3650,196,0,0,0,246,236,10,0,0,0,25-4000,"Librarians, Curators, and Archivists"
27,Minnesota,259,30767,27553,3214,135,145,137,1985,1873,112,2,10,6,25-9000,Other Educational Instruction and Library Occupations
27,Minnesota,271,23173,21527,1646,115,229,0,1082,1017,65,3,8,3,27-1000,Art and Design Workers
27,Minnesota,272,12215,11195,1020,0,33,112,664,627,37,0,2,3,27-2000,"Entertainers and Performers, Sports and Related Workers"
27,Minnesota,273,17177,15208,1969,48,41,134,770,708,62,1,4,7,27-3000,Media and Communication Workers
27,Minnesota,274,5586,5242,344,0,139,0,279,262,17,0,2,1,27-4000,Media and Communication Equipment Workers
27,Minnesota,291,126654,113964,12690,28,461,283,6488,6127,361,2,14,9,29-1000,Healthcare Diagnosing or Treating Practitioners
27,Minnesota,292,57424,51646,5778,64,29,480,3003,2866,137,2,2,11,29-2000,Health Technologists and Technicians
27,Minnesota,299,2240,2091,149,0,0,0,100,97,3,0,0,0,29-9000,Other Healthcare Practitioners and Technical Occupations
27,Minnesota,3111,78116,61348,16768,458,165,702,3816,3416,400,11,6,19,31-1100,"Home Health and Personal Care Aides; and Nursing Assistants, Orderlies, and Psychiatric Aides"
27,Minnesota,312,2878,2454,424,0,46,0,132,128,4,0,1,0,31-2000,Occupational Therapy and Physical Therapist Assistants and Aides
27,Minnesota,319,21718,19817,1901,90,61,121,1127,1068,59,2,3,5,31-9000,Other Healthcare Support Occupations
27,Minnesota,331,4013,3911,102,0,0,0,212,210,2,0,0,0,33-1000,Supervisors of Protective Service Workers
27,Minnesota,332,2555,2426,129,0,19,0,130,126,4,0,1,0,33-2000,Firefighting and Prevention Workers
27,Minnesota,333,16047,15396,651,0,0,119,877,851,26,0,0,5,33-3000,Law Enforcement Workers
27,Minnesota,339,15339,14176,1163,33,116,62,825,795,30,1,1,2,33-9000,Other Protective Service Workers
27,Minnesota,351,15760,13142,2618,50,453,707,662,596,66,2,5,18,35-1000,Supervisors of Food Preparation and Serving Workers
27,Minnesota,352,61677,50786,10891,1351,1289,4261,3288,3004,284,22,31,98,35-2000,Cooks and Food Preparation Workers
27,Minnesota,353,56738,51566,5172,101,335,1286,2927,2738,189,4,13,36,35-3000,Food and Beverage Serving Workers
27,Minnesota,359,14054,12423,1631,113,170,615,901,845,56,3,10,13,35-9000,Other Food Preparation and Serving Related Workers
27,Minnesota,371,7020,6062,958,177,0,581,334,314,20,4,0,12,37-1000,Supervisors of Building and Grounds Cleaning and Maintenance Workers
27,Minnesota,372,62805,49066,13739,780,777,4885,3804,3421,383,24,26,110,37-2000,Building Cleaning and Pest Control Workers
27,Minnesota,373,18180,16467,1713,90,144,985,1350,1311,39,2,3,23,37-3000,Grounds Maintenance Workers
27,Minnesota,391,2367,1896,471,293,30,0,109,102,7,1,2,0,39-1000,Supervisors of Personal Care and Service Workers
27,Minnesota,392,5085,4862,223,0,0,61,324,313,11,1,0,2,39-2000,Animal Care and Service Workers
27,Minnesota,393,6429,6077,352,0,0,0,402,383,19,0,0,0,39-3000,Entertainment Attendants and Related Workers
27,Minnesota,394,986,986,0,0,0,0,50,50,0,0,0,0,39-4000,Funeral Service Workers
27,Minnesota,395,17218,14812,2406,0,23,0,832,761,71,0,1,0,39-5000,Personal Appearance Workers
27,Minnesota,396,762,746,16,0,0,0,38,37,1,0,0,0,39-6000,"Baggage Porters, Bellhops, and Concierges"
27,Minnesota,397,1135,1120,15,0,0,0,81,79,2,0,0,0,39-7000,Tour and Travel Guides
27,Minnesota,399,41094,36816,4278,101,508,236,2539,2413,126,3,15,8,39-9000,Other Personal Care and Service Workers
27,Minnesota,411,78169,72384,5785,123,421,443,3841,3681,160,7,14,10,41-1000,Supervisors of Sales Workers
27,Minnesota,412,109026,99625,9401,398,248,1390,6124,5795,329,10,17,53,41-2000,Retail Sales Workers
27,Minnesota,413,32659,31154,1505,13,140,61,1490,1452,38,1,2,1,41-3000,"Sales Representatives, Services"
27,Minnesota,414,30431,29177,1254,0,0,0,1519,1491,28,0,0,0,41-4000,"Sales Representatives, Wholesale and Manufacturing"
27,Minnesota,419,22109,20750,1359,78,16,513,1073,1029,44,1,2,8,41-9000,Other Sales and Related Workers
27,Minnesota,431,20264,19400,864,77,0,87,1046,1015,31,2,0,3,43-1000,Supervisors of Office and Administrative Support Workers
27,Minnesota,432,816,623,193,0,74,0,46,40,6,0,2,0,43-2000,Communications Equipment Operators
27,Minnesota,433,43483,40520,2963,159,132,147,2593,2488,105,2,7,8,43-3000,Financial Clerks
27,Minnesota,434,99698,92012,7686,79,443,1201,4954,4710,244,4,10,29,43-4000,Information and Record Clerks
27,Minnesota,435,42422,37268,5154,0,94,596,2161,2048,113,0,4,11,43-5000,"Material Recording, Scheduling, Dispatching, and Distributing Workers"
27,Minnesota,436,47382,45231,2151,65,117,196,3084,3003,81,1,8,7,43-6000,Secretaries and Administrative Assistants
27,Minnesota,439,54068,49013,5055,192,409,374,3012,2834,178,6,13,12,43-9000,Other Office and Administrative Support Workers
27,Minnesota,451,957,893,64,0,9,39,77,73,4,0,1,2,45-1000,"Supervisors of Farming, Fishing, and Forestry Workers"
27,Minnesota,452,18650,15251,3399,750,84,1634,1978,1823,155,22,4,84,45-2000,Agricultural Workers
27,Minnesota,453,137,137,0,0,0,0,24,24,0,0,0,0,45-3000,Fishing and Hunting Workers
27,Minnesota,454,1184,1148,36,0,24,12,120,118,2,0,1,1,45-4000,"Forest, Conservation, and Logging Workers"
27,Minnesota,471,11218,10656,562,61,0,237,827,807,20,3,0,9,47-1000,Supervisors of Construction and Extraction Workers
27,Minnesota,472,106370,96954,9416,1993,501,4786,7033,6803,230,35,12,106,47-2000,Construction Trades Workers
27,Minnesota,473,107,99,8,0,0,0,19,18,1,0,0,0,47-3000,"Helpers, Construction Trades"
27,Minnesota,474,7345,7093,252,0,100,0,468,460,8,0,1,0,47-4000,Other Construction and Related Workers
27,Minnesota,475,2049,1818,231,231,0,0,199,196,3,3,0,0,47-5000,Extraction Workers
27,Minnesota,491,3691,3610,81,0,0,42,235,230,5,0,0,2,49-1000,"Supervisors of Installation, Maintenance, and Repair Workers"
27,Minnesota,492,6682,6047,635,0,0,0,349,335,14,0,0,0,49-2000,"Electrical and Electronic Equipment Mechanics, Installers, and Repairers"
27,Minnesota,493,31481,29250,2231,208,340,645,2044,1986,58,2,6,14,49-3000,"Vehicle and Mobile Equipment Mechanics, Installers, and Repairers"
27,Minnesota,499,34964,32886,2078,94,147,182,2210,2149,61,2,4,7,49-9000,"Other Installation, Maintenance, and Repair Occupations"
27,Minnesota,511,19773,18105,1668,66,79,457,1126,1076,50,1,3,14,51-1000,Supervisors of Production Workers
27,Minnesota,512,31721,21975,9746,646,266,692,1769,1482,287,12,13,23,51-2000,Assemblers and Fabricators
27,Minnesota,513,15834,10785,5049,632,127,1571,738,637,101,13,3,33,51-3000,Food Processing Workers
27,Minnesota,514,37551,33196,4355,186,167,859,2371,2228,143,6,3,27,51-4000,Metal Workers and Plastic Workers
27,Minnesota,5151,8352,7320,1032,35,28,78,372,351,21,1,1,1,51-5100,Printing Workers
27,Minnesota,516,7682,5426,2256,325,118,674,420,354,66,5,5,20,51-6000,"Textile, Apparel, and Furnishings Workers"
27,Minnesota,517,4413,4196,217,0,0,153,304,296,8,0,0,3,51-7000,Woodworkers
27,Minnesota,518,5244,5160,84,0,0,3,341,335,6,0,0,1,51-8000,Plant and System Operators
27,Minnesota,519,64307,52435,11872,1066,284,2303,3706,3340,366,18,15,79,51-9000,Other Production Occupations
27,Minnesota,531,3793,3712,81,0,0,0,196,192,4,0,0,0,53-1000,Supervisors of Transportation and Material Moving Workers
27,Minnesota,532,6651,6202,449,0,181,0,311,297,14,0,3,0,53-2000,Air Transportation Workers
27,Minnesota,533,71434,62182,9252,592,235,1139,4560,4339,221,14,9,23,53-3000,Motor Vehicle Operators
27,Minnesota,534,2459,2326,133,0,0,0,150,147,3,0,0,0,53-4000,Rail Transportation Workers
27,Minnesota,535,324,324,0,0,0,0,16,16,0,0,0,0,53-5000,Water Transportation Workers
27,Minnesota,536,3177,2552,625,0,0,47,188,175,13,0,0,1,53-6000,Other Transportation Workers
27,Minnesota,537,97803,85470,12333,793,351,3188,5649,5269,380,26,19,83,53-7000,Material Moving Workers
28,Mississippi,111,10048,9854,194,11,19,0,579,567,12,1,1,0,11-1000,Top Executives
28,Mississippi,112,4165,4019,146,0,0,0,227,219,8,0,0,0,11-2000,"Advertising, Marketing, Promotions, Public Relations, and Sales Managers"
28,Mississippi,113,16807,16471,336,11,22,31,913,896,17,1,2,2,11-3000,Operations Specialties Managers
28,Mississippi,119,58649,56699,1950,68,106,248,3172,3092,80,4,4,13,11-9000,Other Management Occupations
28,Mississippi,131,21596,20876,720,0,102,120,1162,1130,32,0,3,5,13-1000,Business Operations Specialists
28,Mississippi,132,17369,17059,310,8,63,13,1006,987,19,2,2,1,13-2000,Financial Specialists
28,Mississippi,1512,14447,13982,465,0,0,39,792,759,33,1,0,1,15-1200,Computer Occupations
28,Mississippi,152,536,526,10,0,0,0,34,33,1,0,0,0,15-2000,Mathematical Science Occupations
28,Mississippi,171,841,830,11,11,0,0,52,51,1,1,0,0,17-1000,"Architects, Surveyors, and Cartographers"
28,Mississippi,172,9785,9188,597,8,38,78,524,497,27,1,2,4,17-2000,Engineers
28,Mississippi,173,4461,4461,0,0,0,0,289,287,2,2,0,0,17-3000,"Drafters, Engineering Technicians, and Mapping Technicians"
28,Mississippi,191,1706,1596,110,0,13,0,89,78,11,0,1,0,19-1000,Life Scientists
28,Mississippi,192,1729,1468,261,0,0,0,108,93,15,0,0,0,19-2000,Physical Scientists
28,Mississippi,193,1009,1009,0,0,0,0,58,58,0,0,0,0,19-3000,Social Scientists and Related Workers
28,Mississippi,194,2159,2072,87,0,0,0,151,140,11,0,0,0,19-4000,"Life, Physical, and Social Science Technicians"
28,Mississippi,195,522,522,0,0,0,0,35,34,1,0,1,0,19-5000,Occupational Health and Safety Specialists and Technicians
28,Mississippi,211,13382,13303,79,4,0,54,770,765,5,1,0,2,21-1000,"Counselors, Social Workers, and Other Community and Social Service Specialists"
28,Mississippi,212,5810,5696,114,20,0,59,372,366,6,1,0,2,21-2000,Religious Workers
28,Mississippi,231,4275,4259,16,0,0,0,286,284,2,0,0,0,23-1000,"Lawyers, Judges, and Related Workers"
28,Mississippi,232,3679,3617,62,30,0,6,216,212,4,1,0,1,23-2000,Legal Support Workers
28,Mississippi,251,9843,8531,1312,30,62,12,639,563,76,3,4,2,25-1000,Postsecondary Teachers
28,Mississippi,252,50030,49430,600,85,83,4,2969,2937,32,4,5,2,25-2000,"Preschool, Elementary, Middle, Secondary, and Special Education Teachers"
28,Mississippi,253,5071,4909,162,7,6,0,369,360,9,1,1,0,25-3000,Other Teachers and Instructors
28,Mississippi,254,2202,2202,0,0,0,0,154,153,1,0,0,1,25-4000,"Librarians, Curators, and Archivists"
28,Mississippi,259,9586,9086,500,62,76,94,646,619,27,2,2,4,25-9000,Other Educational Instruction and Library Occupations
28,Mississippi,271,3861,3712,149,0,12,74,239,229,10,0,1,4,27-1000,Art and Design Workers
28,Mississippi,272,3415,3328,87,0,0,0,232,225,7,0,0,1,27-2000,"Entertainers and Performers, Sports and Related Workers"
28,Mississippi,273,2799,2733,66,0,27,0,182,172,10,1,3,1,27-3000,Media and Communication Workers
28,Mississippi,274,1476,1476,0,0,0,0,92,91,1,0,0,0,27-4000,Media and Communication Equipment Workers
28,Mississippi,291,57697,55809,1888,62,29,60,3061,2968,93,1,3,3,29-1000,Healthcare Diagnosing or Treating Practitioners
28,Mississippi,292,29799,29489,310,8,0,0,1554,1536,18,1,0,0,29-2000,Health Technologists and Technicians
28,Mississippi,299,810,810,0,0,0,0,41,40,1,0,0,0,29-9000,Other Healthcare Practitioners and Technical Occupations
28,Mississippi,3111,27462,27306,156,0,0,2,1507,1496,11,0,0,1,31-1100,"Home Health and Personal Care Aides; and Nursing Assistants, Orderlies, and Psychiatric Aides"
28,Mississippi,312,1208,1185,23,0,0,0,74,72,2,0,0,0,31-2000,Occupational Therapy and Physical Therapist Assistants and Aides
28,Mississippi,319,8320,8178,142,22,27,0,433,425,8,2,1,1,31-9000,Other Healthcare Support Occupations
28,Mississippi,331,2358,2358,0,0,0,0,162,162,0,0,0,0,33-1000,Supervisors of Protective Service Workers
28,Mississippi,332,3546,3530,16,0,0,0,165,163,2,0,0,0,33-2000,Firefighting and Prevention Workers
28,Mississippi,333,12603,12542,61,0,0,0,678,675,3,0,0,0,33-3000,Law Enforcement Workers
28,Mississippi,339,8973,8961,12,5,0,0,579,575,4,1,1,0,33-9000,Other Protective Service Workers
28,Mississippi,351,6952,6691,261,0,23,0,358,336,22,1,2,1,35-1000,Supervisors of Food Preparation and Serving Workers
28,Mississippi,352,33111,31796,1315,274,16,416,1803,1746,57,8,2,16,35-2000,Cooks and Food Preparation Workers
28,Mississippi,353,24979,23543,1436,118,0,606,1479,1413,66,7,2,22,35-3000,Food and Beverage Serving Workers
28,Mississippi,359,7496,7103,393,125,0,148,418,405,13,2,0,5,35-9000,Other Food Preparation and Serving Related Workers
28,Mississippi,371,3076,3014,62,0,0,0,160,158,2,0,0,0,37-1000,Supervisors of Building and Grounds Cleaning and Maintenance Workers
28,Mississippi,372,31344,29748,1596,310,93,821,1936,1848,88,15,6,36,37-2000,Building Cleaning and Pest Control Workers
28,Mississippi,373,10583,9945,638,97,0,516,636,608,28,4,0,22,37-3000,Grounds Maintenance Workers
28,Mississippi,391,1419,1225,194,0,0,52,75,69,6,0,0,1,39-1000,Supervisors of Personal Care and Service Workers
28,Mississippi,392,2438,2398,40,8,0,32,126,121,5,3,0,1,39-2000,Animal Care and Service Workers
28,Mississippi,393,4121,3695,426,23,16,0,244,217,27,1,1,1,39-3000,Entertainment Attendants and Related Workers
28,Mississippi,394,672,663,9,0,0,9,35,34,1,0,0,1,39-4000,Funeral Service Workers
28,Mississippi,395,8640,7962,678,0,0,24,450,407,43,0,0,2,39-5000,Personal Appearance Workers
28,Mississippi,396,387,387,0,0,0,0,12,12,0,0,0,0,39-6000,"Baggage Porters, Bellhops, and Concierges"
28,Mississippi,397,159,159,0,0,0,0,13,12,1,0,0,1,39-7000,Tour and Travel Guides
28,Mississippi,399,11851,11626,225,0,30,54,921,896,25,0,3,3,39-9000,Other Personal Care and Service Workers
28,Mississippi,411,34583,33317,1266,78,0,205,1823,1762,61,3,1,10,41-1000,Supervisors of Sales Workers
28,Mississippi,412,60041,58576,1465,6,12,243,3711,3626,85,3,1,10,41-2000,Retail Sales Workers
28,Mississippi,413,9682,9554,128,39,0,12,496,485,11,1,1,1,41-3000,"Sales Representatives, Services"
28,Mississippi,414,8042,7912,130,0,9,18,446,439,7,0,1,1,41-4000,"Sales Representatives, Wholesale and Manufacturing"
28,Mississippi,419,5961,5750,211,0,99,45,327,316,11,0,2,3,41-9000,Other Sales and Related Workers
28,Mississippi,431,9661,9433,228,0,85,105,595,586,9,0,1,3,43-1000,Supervisors of Office and Administrative Support Workers
28,Mississippi,432,617,617,0,0,0,0,41,41,0,0,0,0,43-2000,Communications Equipment Operators
28,Mississippi,433,17759,17512,247,18,27,63,1077,1060,17,1,1,3,43-3000,Financial Clerks
28,Mississippi,434,34453,33937,516,44,23,101,1946,1908,38,4,3,10,43-4000,Information and Record Clerks
28,Mississippi,435,16921,16694,227,0,0,225,974,962,12,0,0,8,43-5000,"Material Recording, Scheduling, Dispatching, and Distributing Workers"
28,Mississippi,436,25252,24919,333,32,80,27,1641,1625,16,3,3,1,43-6000,Secretaries and Administrative Assistants
28,Mississippi,439,18175,17945,230,0,12,34,1172,1152,20,0,2,5,43-9000,Other Office and Administrative Support Workers
28,Mississippi,451,663,663,0,0,0,0,36,36,0,0,0,0,45-1000,"Supervisors of Farming, Fishing, and Forestry Workers"
28,Mississippi,452,5348,5082,266,36,0,225,426,402,24,2,0,21,45-2000,Agricultural Workers
28,Mississippi,453,589,341,248,0,0,0,24,14,10,0,0,0,45-3000,Fishing and Hunting Workers
28,Mississippi,454,2382,2382,0,0,0,0,103,103,0,0,0,0,45-4000,"Forest, Conservation, and Logging Workers"
28,Mississippi,471,7467,7258,209,0,17,151,402,392,10,0,1,7,47-1000,Supervisors of Construction and Extraction Workers
28,Mississippi,472,53853,48845,5008,1171,50,3393,2769,2586,183,35,3,123,47-2000,Construction Trades Workers
28,Mississippi,473,397,364,33,15,18,0,31,29,2,1,1,0,47-3000,"Helpers, Construction Trades"
28,Mississippi,474,2544,2507,37,0,0,28,170,168,2,0,0,1,47-4000,Other Construction and Related Workers
28,Mississippi,475,3646,3646,0,0,0,0,195,195,0,0,0,0,47-5000,Extraction Workers
28,Mississippi,491,3031,3015,16,8,0,0,170,168,2,1,0,0,49-1000,"Supervisors of Installation, Maintenance, and Repair Workers"
28,Mississippi,492,4089,4024,65,47,18,0,207,204,3,2,1,0,49-2000,"Electrical and Electronic Equipment Mechanics, Installers, and Repairers"
28,Mississippi,493,18110,17776,334,113,6,68,847,829,18,4,1,4,49-3000,"Vehicle and Mobile Equipment Mechanics, Installers, and Repairers"
28,Mississippi,499,23000,22794,206,76,0,33,1131,1118,13,2,0,3,49-9000,"Other Installation, Maintenance, and Repair Occupations"
28,Mississippi,511,11887,11605,282,29,66,156,617,608,9,1,2,4,51-1000,Supervisors of Production Workers
28,Mississippi,512,19454,19083,371,39,9,284,936,911,25,2,2,15,51-2000,Assemblers and Fabricators
28,Mississippi,513,6934,6496,438,9,0,396,411,392,19,2,0,14,51-3000,Food Processing Workers
28,Mississippi,514,18413,17860,553,44,15,309,931,907,24,2,1,12,51-4000,Metal Workers and Plastic Workers
28,Mississippi,5151,996,961,35,0,0,35,66,65,1,0,0,1,51-5100,Printing Workers
28,Mississippi,516,7127,6541,586,229,15,242,467,432,35,9,1,19,51-6000,"Textile, Apparel, and Furnishings Workers"
28,Mississippi,517,2422,2367,55,24,0,31,133,129,4,1,0,3,51-7000,Woodworkers
28,Mississippi,518,2620,2539,81,0,0,32,134,130,4,0,0,1,51-8000,Plant and System Operators
28,Mississippi,519,33226,31773,1453,162,12,882,1871,1810,61,8,1,39,51-9000,Other Production Occupations
28,Mississippi,531,2352,2201,151,0,0,0,103,101,2,0,0,0,53-1000,Supervisors of Transportation and Material Moving Workers
28,Mississippi,532,1556,1467,89,0,0,0,104,101,3,0,0,0,53-2000,Air Transportation Workers
28,Mississippi,533,46890,46445,445,8,0,120,2393,2373,20,1,0,5,53-3000,Motor Vehicle Operators
28,Mississippi,534,1023,1023,0,0,0,0,50,50,0,0,0,0,53-4000,Rail Transportation Workers
28,Mississippi,535,2681,2635,46,39,0,0,123,120,3,2,0,0,53-5000,Water Transportation Workers
28,Mississippi,536,2779,2763,16,0,0,0,116,115,1,0,0,0,53-6000,Other Transportation Workers
28,Mississippi,537,53660,52177,1483,133,40,964,3111,3047,64,6,2,37,53-7000,Material Moving Workers
29,Missouri,111,35348,33645,1703,84,100,193,1800,1734,66,2,5,5,11-1000,Top Executives
29,Missouri,112,17526,17153,373,18,55,0,886,866,20,1,2,1,11-2000,"Advertising, Marketing, Promotions, Public Relations, and Sales Managers"
29,Missouri,113,54536,52086,2450,106,93,123,2863,2761,102,4,5,7,11-3000,Operations Specialties Managers
29,Missouri,119,157679,150427,7252,246,363,970,8734,8425,309,12,16,45,11-9000,Other Management Occupations
29,Missouri,131,82070,78951,3119,95,237,166,4253,4108,145,3,10,10,13-1000,Business Operations Specialists
29,Missouri,132,61798,58390,3408,187,106,300,3236,3089,147,4,5,9,13-2000,Financial Specialists
29,Missouri,1512,76287,66438,9849,176,363,112,3814,3450,364,8,13,7,15-1200,Computer Occupations
29,Missouri,152,4439,4007,432,0,32,0,214,197,17,0,2,0,15-2000,Mathematical Science Occupations
29,Missouri,171,3659,3459,200,0,33,48,212,202,10,0,2,2,17-1000,"Architects, Surveyors, and Cartographers"
29,Missouri,172,25978,23990,1988,0,182,207,1365,1262,103,0,7,10,17-2000,Engineers
29,Missouri,173,10146,9874,272,0,2,25,603,583,20,0,1,1,17-3000,"Drafters, Engineering Technicians, and Mapping Technicians"
29,Missouri,191,4776,3626,1150,0,112,15,273,221,52,0,4,1,19-1000,Life Scientists
29,Missouri,192,8327,5413,2914,0,0,35,394,287,107,0,0,2,19-2000,Physical Scientists
29,Missouri,193,3229,3054,175,0,7,0,176,166,10,0,1,0,19-3000,Social Scientists and Related Workers
29,Missouri,194,6421,5931,490,0,23,19,407,374,33,1,1,1,19-4000,"Life, Physical, and Social Science Technicians"
29,Missouri,195,972,925,47,0,47,0,40,39,1,0,1,0,19-5000,Occupational Health and Safety Specialists and Technicians
29,Missouri,211,34564,33433,1131,43,35,184,1938,1881,57,2,2,11,21-1000,"Counselors, Social Workers, and Other Community and Social Service Specialists"
29,Missouri,212,11260,10779,481,46,22,71,724,695,29,4,1,3,21-2000,Religious Workers
29,Missouri,231,14567,14143,424,0,20,28,761,738,23,0,2,1,23-1000,"Lawyers, Judges, and Related Workers"
29,Missouri,232,8189,8083,106,0,0,32,466,461,5,0,0,1,23-2000,Legal Support Workers
29,Missouri,251,23994,18913,5081,55,212,100,1305,1059,246,3,11,4,25-1000,Postsecondary Teachers
29,Missouri,252,101902,99767,2135,71,170,218,5987,5865,122,4,11,8,25-2000,"Preschool, Elementary, Middle, Secondary, and Special Education Teachers"
29,Missouri,253,13099,12544,555,25,55,119,828,791,37,2,2,3,25-3000,Other Teachers and Instructors
29,Missouri,254,6040,5664,376,0,0,174,356,341,15,0,0,1,25-4000,"Librarians, Curators, and Archivists"
29,Missouri,259,19270,18190,1080,5,181,66,1254,1174,80,2,13,3,25-9000,Other Educational Instruction and Library Occupations
29,Missouri,271,16853,15813,1040,0,58,42,942,904,38,0,4,2,27-1000,Art and Design Workers
29,Missouri,272,9782,9252,530,0,64,18,627,594,33,0,2,1,27-2000,"Entertainers and Performers, Sports and Related Workers"
29,Missouri,273,12521,11590,931,39,182,107,679,635,44,2,8,8,27-3000,Media and Communication Workers
29,Missouri,274,4339,4196,143,0,0,58,270,264,6,0,0,2,27-4000,Media and Communication Equipment Workers
29,Missouri,291,116970,108455,8515,84,212,221,6324,5960,364,4,10,7,29-1000,Healthcare Diagnosing or Treating Practitioners
29,Missouri,292,64439,61612,2827,63,77,125,3481,3356,125,3,5,8,29-2000,Health Technologists and Technicians
29,Missouri,299,1458,1313,145,0,0,0,68,65,3,0,0,0,29-9000,Other Healthcare Practitioners and Technical Occupations
29,Missouri,3111,62006,58983,3023,70,39,325,3582,3459,123,2,3,14,31-1100,"Home Health and Personal Care Aides; and Nursing Assistants, Orderlies, and Psychiatric Aides"
29,Missouri,312,2736,2700,36,0,0,0,145,142,3,0,0,0,31-2000,Occupational Therapy and Physical Therapist Assistants and Aides
29,Missouri,319,25323,24438,885,36,39,133,1271,1229,42,2,1,6,31-9000,Other Healthcare Support Occupations
29,Missouri,331,4993,4940,53,0,0,0,326,324,2,0,0,0,33-1000,Supervisors of Protective Service Workers
29,Missouri,332,5832,5787,45,0,43,0,289,286,3,0,2,0,33-2000,Firefighting and Prevention Workers
29,Missouri,333,23475,22781,694,0,0,24,1305,1278,27,0,1,3,33-3000,Law Enforcement Workers
29,Missouri,339,17710,17340,370,0,18,34,1168,1149,19,0,2,1,33-9000,Other Protective Service Workers
29,Missouri,351,17970,15963,2007,97,83,388,830,754,76,1,2,15,35-1000,Supervisors of Food Preparation and Serving Workers
29,Missouri,352,63131,57760,5371,770,96,2282,3992,3753,239,32,6,80,35-2000,Cooks and Food Preparation Workers
29,Missouri,353,67542,63306,4236,220,309,1546,3759,3589,170,14,13,45,35-3000,Food and Beverage Serving Workers
29,Missouri,359,19315,18069,1246,188,36,373,1182,1118,64,5,1,14,35-9000,Other Food Preparation and Serving Related Workers
29,Missouri,371,5949,5679,270,108,0,70,321,309,12,3,0,3,37-1000,Supervisors of Building and Grounds Cleaning and Maintenance Workers
29,Missouri,372,68040,61922,6118,466,355,2119,4141,3869,272,23,13,81,37-2000,Building Cleaning and Pest Control Workers
29,Missouri,373,20472,18807,1665,360,41,1118,1388,1311,77,12,2,42,37-3000,Grounds Maintenance Workers
29,Missouri,391,1642,1493,149,0,0,0,91,84,7,0,0,0,39-1000,Supervisors of Personal Care and Service Workers
29,Missouri,392,6029,5778,251,48,0,12,348,334,14,2,0,1,39-2000,Animal Care and Service Workers
29,Missouri,393,5862,5644,218,4,51,7,410,392,18,1,2,1,39-3000,Entertainment Attendants and Related Workers
29,Missouri,394,1362,1362,0,0,0,0,68,68,0,0,0,0,39-4000,Funeral Service Workers
29,Missouri,395,19010,16143,2867,0,0,36,982,872,110,0,0,2,39-5000,Personal Appearance Workers
29,Missouri,396,1072,1045,27,0,0,0,46,45,1,0,0,0,39-6000,"Baggage Porters, Bellhops, and Concierges"
29,Missouri,397,796,796,0,0,0,0,62,59,3,0,0,0,39-7000,Tour and Travel Guides
29,Missouri,399,34275,33265,1010,2,31,214,2297,2233,64,2,3,17,39-9000,Other Personal Care and Service Workers
29,Missouri,411,78784,76320,2464,57,100,296,4212,4097,115,3,7,14,41-1000,Supervisors of Sales Workers
29,Missouri,412,115858,111055,4803,317,81,484,7288,7049,239,12,8,31,41-2000,Retail Sales Workers
29,Missouri,413,30546,29757,789,0,90,100,1539,1504,35,0,3,4,41-3000,"Sales Representatives, Services"
29,Missouri,414,25741,25190,551,69,46,79,1344,1310,34,2,3,3,41-4000,"Sales Representatives, Wholesale and Manufacturing"
29,Missouri,419,21533,21119,414,0,93,50,1191,1165,26,0,6,7,41-9000,Other Sales and Related Workers
29,Missouri,431,23066,22252,814,45,0,113,1264,1230,34,3,1,1,43-1000,Supervisors of Office and Administrative Support Workers
29,Missouri,432,1736,1736,0,0,0,0,81,80,1,0,0,0,43-2000,Communications Equipment Operators
29,Missouri,433,45962,44953,1009,46,20,136,2783,2719,64,6,2,4,43-3000,Financial Clerks
29,Missouri,434,105104,102253,2851,248,94,665,5645,5498,147,12,7,22,43-4000,Information and Record Clerks
29,Missouri,435,41647,39867,1780,78,0,242,2325,2263,62,3,0,11,43-5000,"Material Recording, Scheduling, Dispatching, and Distributing Workers"
29,Missouri,436,54951,53932,1019,0,26,171,3546,3487,59,0,1,9,43-6000,Secretaries and Administrative Assistants
29,Missouri,439,55944,54649,1295,122,80,208,3297,3230,67,7,7,11,43-9000,Other Office and Administrative Support Workers
29,Missouri,451,796,788,8,0,0,8,49,48,1,0,0,1,45-1000,"Supervisors of Farming, Fishing, and Forestry Workers"
29,Missouri,452,13347,12691,656,11,0,638,1136,1092,44,4,0,37,45-2000,Agricultural Workers
29,Missouri,453,6,6,0,0,0,0,3,3,0,0,0,0,45-3000,Fishing and Hunting Workers
29,Missouri,454,1941,1941,0,0,0,0,126,126,0,0,0,0,45-4000,"Forest, Conservation, and Logging Workers"
29,Missouri,471,14446,13769,677,16,147,389,801,780,21,2,1,11,47-1000,Supervisors of Construction and Extraction Workers
29,Missouri,472,122577,114923,7654,1791,180,4176,6981,6706,275,47,12,137,47-2000,Construction Trades Workers
29,Missouri,473,221,221,0,0,0,0,23,23,0,0,0,0,47-3000,"Helpers, Construction Trades"
29,Missouri,474,6838,6608,230,44,0,105,431,423,8,1,0,3,47-4000,Other Construction and Related Workers
29,Missouri,475,1790,1700,90,0,0,90,134,131,3,0,0,3,47-5000,Extraction Workers
29,Missouri,491,4391,4345,46,0,18,0,285,281,4,0,1,1,49-1000,"Supervisors of Installation, Maintenance, and Repair Workers"
29,Missouri,492,8345,8110,235,0,21,0,455,444,11,0,1,0,49-2000,"Electrical and Electronic Equipment Mechanics, Installers, and Repairers"
29,Missouri,493,34722,33108,1614,113,103,608,2037,1982,55,5,1,18,49-3000,"Vehicle and Mobile Equipment Mechanics, Installers, and Repairers"
29,Missouri,499,38802,37331,1471,124,15,584,2267,2199,68,4,2,20,49-9000,"Other Installation, Maintenance, and Repair Occupations"
29,Missouri,511,20349,19420,929,0,29,302,1140,1106,34,0,1,11,51-1000,Supervisors of Production Workers
29,Missouri,512,30889,28997,1892,104,0,444,1756,1673,83,3,0,17,51-2000,Assemblers and Fabricators
29,Missouri,513,16022,13055,2967,340,18,831,863,756,107,21,1,39,51-3000,Food Processing Workers
29,Missouri,514,36264,34193,2071,186,0,810,2190,2108,82,6,0,32,51-4000,Metal Workers and Plastic Workers
29,Missouri,5151,4757,4547,210,0,0,0,318,310,8,1,0,0,51-5100,Printing Workers
29,Missouri,516,7904,6631,1273,53,19,311,488,437,51,3,1,10,51-6000,"Textile, Apparel, and Furnishings Workers"
29,Missouri,517,3671,3530,141,0,0,53,256,249,7,0,0,2,51-7000,Woodworkers
29,Missouri,518,4393,4315,78,0,0,54,249,246,3,0,0,2,51-8000,Plant and System Operators
29,Missouri,519,66170,60210,5960,825,40,1843,3912,3651,261,32,3,89,51-9000,Other Production Occupations
29,Missouri,531,4209,4063,146,0,34,1,239,232,7,0,1,1,53-1000,Supervisors of Transportation and Material Moving Workers
29,Missouri,532,3969,3789,180,0,0,50,199,190,9,0,0,2,53-2000,Air Transportation Workers
29,Missouri,533,86213,82668,3545,81,24,454,4936,4784,152,4,2,17,53-3000,Motor Vehicle Operators
29,Missouri,534,3773,3701,72,0,0,0,233,231,2,0,0,0,53-4000,Rail Transportation Workers
29,Missouri,535,1160,1160,0,0,0,0,74,74,0,0,0,0,53-5000,Water Transportation Workers
29,Missouri,536,5386,5178,208,9,9,26,298,287,11,2,2,1,53-6000,Other Transportation Workers
29,Missouri,537,116656,111052,5604,709,37,2030,7159,6910,249,26,6,82,53-7000,Material Moving Workers
30,Montana,111,5971,5932,39,0,0,0,308,306,2,0,0,0,11-1000,Top Executives
30,Montana,112,2170,2038,132,0,30,0,88,82,6,0,1,0,11-2000,"Advertising, Marketing, Promotions, Public Relations, and Sales Managers"
30,Montana,113,7626,7517,109,0,0,17,375,366,9,0,0,1,11-3000,Operations Specialties Managers
30,Montana,119,35453,34923,530,0,37,27,2407,2374,33,0,1,2,11-9000,Other Management Occupations
30,Montana,131,12424,12076,348,0,31,0,578,567,11,0,2,0,13-1000,Business Operations Specialists
30,Montana,132,7785,7601,184,0,0,0,401,392,9,0,0,0,13-2000,Financial Specialists
30,Montana,1512,8755,8543,212,0,0,0,382,376,6,0,0,0,15-1200,Computer Occupations
30,Montana,152,260,260,0,0,0,0,17,17,0,0,0,0,15-2000,Mathematical Science Occupations
30,Montana,171,838,714,124,0,0,114,40,37,3,0,0,1,17-1000,"Architects, Surveyors, and Cartographers"
30,Montana,172,4532,4394,138,0,0,0,230,221,9,0,0,0,17-2000,Engineers
30,Montana,173,2342,2330,12,0,0,0,110,107,3,0,0,0,17-3000,"Drafters, Engineering Technicians, and Mapping Technicians"
30,Montana,191,1448,1420,28,0,0,0,82,81,1,0,0,0,19-1000,Life Scientists
30,Montana,192,1676,1453,223,0,0,0,87,82,5,0,0,0,19-2000,Physical Scientists
30,Montana,193,1202,1202,0,0,0,0,45,45,0,0,0,0,19-3000,Social Scientists and Related Workers
30,Montana,194,1940,1876,64,0,0,0,107,104,3,0,0,0,19-4000,"Life, Physical, and Social Science Technicians"
30,Montana,195,201,201,0,0,0,0,14,14,0,0,0,0,19-5000,Occupational Health and Safety Specialists and Technicians
30,Montana,211,7299,7120,179,0,82,0,374,364,10,0,2,0,21-1000,"Counselors, Social Workers, and Other Community and Social Service Specialists"
30,Montana,212,1576,1500,76,0,0,0,98,95,3,0,0,0,21-2000,Religious Workers
30,Montana,231,2684,2652,32,0,0,0,120,117,3,0,0,0,23-1000,"Lawyers, Judges, and Related Workers"
30,Montana,232,1733,1733,0,0,0,0,72,72,0,0,0,0,23-2000,Legal Support Workers
30,Montana,251,4477,3396,1081,0,86,0,190,166,24,0,3,0,25-1000,Postsecondary Teachers
30,Montana,252,14722,14519,203,0,0,0,941,928,13,0,2,0,25-2000,"Preschool, Elementary, Middle, Secondary, and Special Education Teachers"
30,Montana,253,2113,1959,154,0,0,48,126,122,4,0,0,1,25-3000,Other Teachers and Instructors
30,Montana,254,802,802,0,0,0,0,42,42,0,0,0,0,25-4000,"Librarians, Curators, and Archivists"
30,Montana,259,3798,3736,62,0,19,0,254,247,7,0,2,0,25-9000,Other Educational Instruction and Library Occupations
30,Montana,271,3009,2948,61,0,0,0,169,163,6,0,1,0,27-1000,Art and Design Workers
30,Montana,272,1621,1565,56,0,0,0,107,102,5,0,1,0,27-2000,"Entertainers and Performers, Sports and Related Workers"
30,Montana,273,2441,2354,87,0,28,0,109,105,4,0,1,0,27-3000,Media and Communication Workers
30,Montana,274,1046,939,107,0,0,0,56,53,3,0,0,0,27-4000,Media and Communication Equipment Workers
30,Montana,291,21380,20945,435,97,0,0,1016,995,21,1,0,0,29-1000,Healthcare Diagnosing or Treating Practitioners
30,Montana,292,8808,8550,258,0,0,0,411,394,17,0,0,0,29-2000,Health Technologists and Technicians
30,Montana,299,208,208,0,0,0,0,14,14,0,0,0,0,29-9000,Other Healthcare Practitioners and Technical Occupations
30,Montana,3111,10748,10330,418,0,35,13,559,544,15,0,3,1,31-1100,"Home Health and Personal Care Aides; and Nursing Assistants, Orderlies, and Psychiatric Aides"
30,Montana,312,336,323,13,0,0,0,21,20,1,0,0,0,31-2000,Occupational Therapy and Physical Therapist Assistants and Aides
30,Montana,319,4317,4231,86,0,0,86,204,202,2,0,0,1,31-9000,Other Healthcare Support Occupations
30,Montana,331,922,882,40,0,0,0,50,48,2,0,0,0,33-1000,Supervisors of Protective Service Workers
30,Montana,332,1650,1650,0,0,0,0,91,91,0,0,0,0,33-2000,Firefighting and Prevention Workers
30,Montana,333,4493,4445,48,0,48,0,220,218,2,0,1,0,33-3000,Law Enforcement Workers
30,Montana,339,2906,2906,0,0,0,0,173,171,2,0,0,0,33-9000,Other Protective Service Workers
30,Montana,351,3495,3457,38,0,0,9,157,155,2,0,0,1,35-1000,Supervisors of Food Preparation and Serving Workers
30,Montana,352,13322,12894,428,18,18,81,715,695,20,1,1,1,35-2000,Cooks and Food Preparation Workers
30,Montana,353,13944,13202,742,31,0,0,656,637,19,1,0,0,35-3000,Food and Beverage Serving Workers
30,Montana,359,3390,3220,170,0,0,0,186,181,5,0,0,0,35-9000,Other Food Preparation and Serving Related Workers
30,Montana,371,1355,1351,4,0,0,0,58,56,2,0,0,0,37-1000,Supervisors of Building and Grounds Cleaning and Maintenance Workers
30,Montana,372,14428,13396,1032,26,0,362,840,815,25,1,0,6,37-2000,Building Cleaning and Pest Control Workers
30,Montana,373,4453,4453,0,0,0,0,299,295,4,0,0,0,37-3000,Grounds Maintenance Workers
30,Montana,391,222,222,0,0,0,0,13,13,0,0,0,0,39-1000,Supervisors of Personal Care and Service Workers
30,Montana,392,1540,1540,0,0,0,0,81,81,0,0,0,0,39-2000,Animal Care and Service Workers
30,Montana,393,1927,1927,0,0,0,0,64,64,0,0,0,0,39-3000,Entertainment Attendants and Related Workers
30,Montana,394,33,33,0,0,0,0,2,2,0,0,0,0,39-4000,Funeral Service Workers
30,Montana,395,3583,3518,65,0,0,0,161,158,3,0,0,0,39-5000,Personal Appearance Workers
30,Montana,396,214,214,0,0,0,0,10,10,0,0,0,0,39-6000,"Baggage Porters, Bellhops, and Concierges"
30,Montana,397,1062,1062,0,0,0,0,63,63,0,0,0,0,39-7000,Tour and Travel Guides
30,Montana,399,6248,6143,105,0,0,0,391,382,9,0,0,0,39-9000,Other Personal Care and Service Workers
30,Montana,411,15003,14852,151,0,22,0,722,713,9,0,2,0,41-1000,Supervisors of Sales Workers
30,Montana,412,20167,19853,314,0,87,0,1059,1041,18,0,2,0,41-2000,Retail Sales Workers
30,Montana,413,4169,4131,38,0,0,0,196,192,4,0,0,0,41-3000,"Sales Representatives, Services"
30,Montana,414,4442,4396,46,0,0,0,185,183,2,0,0,0,41-4000,"Sales Representatives, Wholesale and Manufacturing"
30,Montana,419,3671,3608,63,0,0,0,184,179,5,0,0,0,41-9000,Other Sales and Related Workers
30,Montana,431,4011,3975,36,0,0,0,211,210,1,0,0,0,43-1000,Supervisors of Office and Administrative Support Workers
30,Montana,432,146,146,0,0,0,0,6,6,0,0,0,0,43-2000,Communications Equipment Operators
30,Montana,433,9343,9149,194,0,0,0,548,533,15,0,0,0,43-3000,Financial Clerks
30,Montana,434,16931,16311,620,0,0,0,809,799,10,0,0,0,43-4000,Information and Record Clerks
30,Montana,435,5245,5156,89,0,0,0,329,325,4,0,0,0,43-5000,"Material Recording, Scheduling, Dispatching, and Distributing Workers"
30,Montana,436,9887,9804,83,0,0,0,621,613,8,0,0,0,43-6000,Secretaries and Administrative Assistants
30,Montana,439,7221,7071,150,0,7,0,398,391,7,0,1,0,43-9000,Other Office and Administrative Support Workers
30,Montana,451,648,540,108,0,0,108,39,38,1,0,0,1,45-1000,"Supervisors of Farming, Fishing, and Forestry Workers"
30,Montana,452,6210,5653,557,0,68,328,681,647,34,0,7,16,45-2000,Agricultural Workers
30,Montana,453,115,115,0,0,0,0,14,14,0,0,0,0,45-3000,Fishing and Hunting Workers
30,Montana,454,900,879,21,0,0,21,58,57,1,0,0,1,45-4000,"Forest, Conservation, and Logging Workers"
30,Montana,471,3847,3645,202,0,0,47,223,219,4,0,0,1,47-1000,Supervisors of Construction and Extraction Workers
30,Montana,472,26995,26299,696,0,0,298,1356,1328,28,4,0,9,47-2000,Construction Trades Workers
30,Montana,473,172,172,0,0,0,0,8,8,0,0,0,0,47-3000,"Helpers, Construction Trades"
30,Montana,474,1802,1802,0,0,0,0,121,121,0,0,0,0,47-4000,Other Construction and Related Workers
30,Montana,475,3098,3098,0,0,0,0,174,173,1,0,0,0,47-5000,Extraction Workers
30,Montana,491,1193,1193,0,0,0,0,50,50,0,0,0,0,49-1000,"Supervisors of Installation, Maintenance, and Repair Workers"
30,Montana,492,998,984,14,0,0,0,62,60,2,0,1,0,49-2000,"Electrical and Electronic Equipment Mechanics, Installers, and Repairers"
30,Montana,493,8223,8050,173,0,0,82,399,392,7,0,0,1,49-3000,"Vehicle and Mobile Equipment Mechanics, Installers, and Repairers"
30,Montana,499,6105,6105,0,0,0,0,314,314,0,0,0,0,49-9000,"Other Installation, Maintenance, and Repair Occupations"
30,Montana,511,1720,1627,93,0,7,86,93,91,2,0,1,1,51-1000,Supervisors of Production Workers
30,Montana,512,1850,1850,0,0,0,0,78,78,0,0,0,0,51-2000,Assemblers and Fabricators
30,Montana,513,2288,2288,0,0,0,0,114,114,0,0,0,0,51-3000,Food Processing Workers
30,Montana,514,3373,3366,7,0,0,7,172,171,1,0,0,1,51-4000,Metal Workers and Plastic Workers
30,Montana,5151,470,470,0,0,0,0,25,24,1,0,0,0,51-5100,Printing Workers
30,Montana,516,1638,1592,46,0,0,0,97,93,4,0,0,1,51-6000,"Textile, Apparel, and Furnishings Workers"
30,Montana,517,773,773,0,0,0,0,36,36,0,0,0,0,51-7000,Woodworkers
30,Montana,518,1640,1640,0,0,0,0,78,78,0,0,0,0,51-8000,Plant and System Operators
30,Montana,519,6328,6310,18,0,0,0,313,312,1,0,0,0,51-9000,Other Production Occupations
30,Montana,531,854,766,88,88,0,0,40,39,1,1,0,0,53-1000,Supervisors of Transportation and Material Moving Workers
30,Montana,532,876,876,0,0,0,0,38,38,0,0,0,0,53-2000,Air Transportation Workers
30,Montana,533,12353,12157,196,0,0,0,730,719,11,0,0,0,53-3000,Motor Vehicle Operators
30,Montana,534,1914,1914,0,0,0,0,89,89,0,0,0,0,53-4000,Rail Transportation Workers
30,Montana,535,75,75,0,0,0,0,7,7,0,0,0,0,53-5000,Water Transportation Workers
30,Montana,536,1096,1079,17,0,0,17,50,49,1,0,0,1,53-6000,Other Transportation Workers
30,Montana,537,13118,12901,217,0,0,0,762,751,11,0,0,0,53-7000,Material Moving Workers
31,Nebraska,111,11054,10853,201,0,0,29,578,570,8,0,0,1,11-1000,Top Executives
31,Nebraska,112,5490,5230,260,0,0,116,266,255,11,0,0,2,11-2000,"Advertising, Marketing, Promotions, Public Relations, and Sales Managers"
31,Nebraska,113,20188,19313,875,15,26,235,938,906,32,2,3,6,11-3000,Operations Specialties Managers
31,Nebraska,119,60931,58278,2653,320,123,625,3569,3469,100,7,2,22,11-9000,Other Management Occupations
31,Nebraska,131,28169,27063,1106,0,16,167,1281,1245,36,0,3,5,13-1000,Business Operations Specialists
31,Nebraska,132,19834,18837,997,63,0,221,1028,997,31,2,0,5,13-2000,Financial Specialists
31,Nebraska,1512,26071,23054,3017,41,21,90,1164,1063,101,2,1,5,15-1200,Computer Occupations
31,Nebraska,152,1559,1559,0,0,0,0,76,76,0,0,0,0,15-2000,Mathematical Science Occupations
31,Nebraska,171,698,698,0,0,0,0,39,38,1,0,0,1,17-1000,"Architects, Surveyors, and Cartographers"
31,Nebraska,172,7099,6538,561,11,0,64,328,310,18,2,0,2,17-2000,Engineers
31,Nebraska,173,4390,4097,293,14,30,130,224,216,8,1,2,1,17-3000,"Drafters, Engineering Technicians, and Mapping Technicians"
31,Nebraska,191,2248,1698,550,0,0,0,110,97,13,0,0,0,19-1000,Life Scientists
31,Nebraska,192,1825,1451,374,0,38,52,80,61,19,0,2,2,19-2000,Physical Scientists
31,Nebraska,193,1291,1238,53,0,26,0,66,64,2,0,1,0,19-3000,Social Scientists and Related Workers
31,Nebraska,194,3092,2583,509,86,40,59,184,162,22,2,4,5,19-4000,"Life, Physical, and Social Science Technicians"
31,Nebraska,195,373,304,69,0,0,69,21,19,2,0,0,2,19-5000,Occupational Health and Safety Specialists and Technicians
31,Nebraska,211,12885,11978,907,0,0,224,652,624,28,0,1,7,21-1000,"Counselors, Social Workers, and Other Community and Social Service Specialists"
31,Nebraska,212,3853,3376,477,0,48,10,226,213,13,0,1,1,21-2000,Religious Workers
31,Nebraska,231,4764,4635,129,0,0,23,204,198,6,0,0,1,23-1000,"Lawyers, Judges, and Related Workers"
31,Nebraska,232,2576,2507,69,0,0,4,134,127,7,0,0,2,23-2000,Legal Support Workers
31,Nebraska,251,10133,8133,2000,28,130,165,457,381,76,1,7,5,25-1000,Postsecondary Teachers
31,Nebraska,252,36164,35569,595,3,106,139,2028,2004,24,2,1,6,25-2000,"Preschool, Elementary, Middle, Secondary, and Special Education Teachers"
31,Nebraska,253,3957,3726,231,33,32,86,238,228,10,1,2,5,25-3000,Other Teachers and Instructors
31,Nebraska,254,1334,1280,54,0,0,54,86,85,1,0,0,1,25-4000,"Librarians, Curators, and Archivists"
31,Nebraska,259,9977,9091,886,108,44,423,619,591,28,2,2,11,25-9000,Other Educational Instruction and Library Occupations
31,Nebraska,271,5046,4828,218,0,59,76,250,241,9,0,2,3,27-1000,Art and Design Workers
31,Nebraska,272,2752,2675,77,0,0,0,190,181,9,1,0,0,27-2000,"Entertainers and Performers, Sports and Related Workers"
31,Nebraska,273,4944,4677,267,26,22,50,237,223,14,1,1,3,27-3000,Media and Communication Workers
31,Nebraska,274,1861,1822,39,0,0,18,97,95,2,0,0,1,27-4000,Media and Communication Equipment Workers
31,Nebraska,291,40510,38738,1772,15,155,270,2007,1935,72,1,3,8,29-1000,Healthcare Diagnosing or Treating Practitioners
31,Nebraska,292,15507,15119,388,36,9,27,915,897,18,1,2,2,29-2000,Health Technologists and Technicians
31,Nebraska,299,351,351,0,0,0,0,22,22,0,0,0,0,29-9000,Other Healthcare Practitioners and Technical Occupations
31,Nebraska,3111,21460,18780,2680,0,0,549,1189,1117,72,0,0,15,31-1100,"Home Health and Personal Care Aides; and Nursing Assistants, Orderlies, and Psychiatric Aides"
31,Nebraska,312,1063,997,66,0,0,0,57,55,2,0,0,0,31-2000,Occupational Therapy and Physical Therapist Assistants and Aides
31,Nebraska,319,8006,7684,322,0,0,79,392,383,9,0,1,3,31-9000,Other Healthcare Support Occupations
31,Nebraska,331,1794,1733,61,0,19,0,76,73,3,0,1,0,33-1000,Supervisors of Protective Service Workers
31,Nebraska,332,1389,1371,18,0,0,0,66,65,1,0,0,0,33-2000,Firefighting and Prevention Workers
31,Nebraska,333,6605,6377,228,65,25,54,348,338,10,2,1,4,33-3000,Law Enforcement Workers
31,Nebraska,339,6049,5613,436,0,0,0,426,411,15,1,0,0,33-9000,Other Protective Service Workers
31,Nebraska,351,5358,5074,284,0,33,53,276,261,15,0,1,3,35-1000,Supervisors of Food Preparation and Serving Workers
31,Nebraska,352,20761,17677,3084,391,85,1735,1261,1160,101,14,2,48,35-2000,Cooks and Food Preparation Workers
31,Nebraska,353,16973,15736,1237,46,53,419,972,920,52,1,3,9,35-3000,Food and Beverage Serving Workers
31,Nebraska,359,5092,4171,921,79,0,633,314,285,29,1,0,15,35-9000,Other Food Preparation and Serving Related Workers
31,Nebraska,371,2269,1932,337,0,58,239,111,100,11,1,2,6,37-1000,Supervisors of Building and Grounds Cleaning and Maintenance Workers
31,Nebraska,372,21729,16724,5005,539,302,2864,1277,1113,164,17,7,90,37-2000,Building Cleaning and Pest Control Workers
31,Nebraska,373,6096,5344,752,150,93,284,518,492,26,6,1,9,37-3000,Grounds Maintenance Workers
31,Nebraska,391,552,552,0,0,0,0,25,25,0,0,0,0,39-1000,Supervisors of Personal Care and Service Workers
31,Nebraska,392,1940,1895,45,0,0,19,115,111,4,0,0,3,39-2000,Animal Care and Service Workers
31,Nebraska,393,1599,1483,116,24,0,0,118,112,6,1,0,0,39-3000,Entertainment Attendants and Related Workers
31,Nebraska,394,301,301,0,0,0,0,15,15,0,0,0,0,39-4000,Funeral Service Workers
31,Nebraska,395,6227,5525,702,0,0,48,322,294,28,0,0,4,39-5000,Personal Appearance Workers
31,Nebraska,396,110,110,0,0,0,0,5,5,0,0,0,0,39-6000,"Baggage Porters, Bellhops, and Concierges"
31,Nebraska,397,241,241,0,0,0,0,15,15,0,0,0,0,39-7000,Tour and Travel Guides
31,Nebraska,399,16096,15575,521,14,115,192,1054,1023,31,1,2,11,39-9000,Other Personal Care and Service Workers
31,Nebraska,411,28202,26815,1387,133,25,302,1415,1368,47,5,1,11,41-1000,Supervisors of Sales Workers
31,Nebraska,412,34552,32883,1669,53,77,530,2105,2028,77,7,5,17,41-2000,Retail Sales Workers
31,Nebraska,413,10881,10540,341,21,21,119,515,504,11,1,1,4,41-3000,"Sales Representatives, Services"
31,Nebraska,414,8140,7923,217,0,0,76,419,413,6,0,0,3,41-4000,"Sales Representatives, Wholesale and Manufacturing"
31,Nebraska,419,6362,6165,197,0,59,43,331,322,9,0,2,4,41-9000,Other Sales and Related Workers
31,Nebraska,431,7858,7653,205,0,0,0,419,413,6,0,0,0,43-1000,Supervisors of Office and Administrative Support Workers
31,Nebraska,432,456,369,87,0,0,0,25,24,1,0,0,0,43-2000,Communications Equipment Operators
31,Nebraska,433,18036,17135,901,79,39,337,1025,995,30,2,1,10,43-3000,Financial Clerks
31,Nebraska,434,33402,31699,1703,22,35,627,1749,1684,65,5,1,18,43-4000,Information and Record Clerks
31,Nebraska,435,12728,11988,740,281,36,132,715,692,23,6,1,5,43-5000,"Material Recording, Scheduling, Dispatching, and Distributing Workers"
31,Nebraska,436,19292,18506,786,21,17,253,1224,1201,23,1,2,8,43-6000,Secretaries and Administrative Assistants
31,Nebraska,439,19143,17347,1796,20,19,489,1082,1036,46,1,2,9,43-9000,Other Office and Administrative Support Workers
31,Nebraska,451,584,562,22,0,0,22,39,35,4,0,0,4,45-1000,"Supervisors of Farming, Fishing, and Forestry Workers"
31,Nebraska,452,12267,10487,1780,285,45,1412,1108,1031,77,10,1,61,45-2000,Agricultural Workers
31,Nebraska,453,0,0,0,0,0,0,2,2,0,0,0,0,45-3000,Fishing and Hunting Workers
31,Nebraska,454,210,210,0,0,0,0,14,14,0,0,0,0,45-4000,"Forest, Conservation, and Logging Workers"
31,Nebraska,471,4879,4516,363,24,0,329,291,276,15,2,1,11,47-1000,Supervisors of Construction and Extraction Workers
31,Nebraska,472,42687,33822,8865,2120,175,5736,2195,1978,217,52,5,136,47-2000,Construction Trades Workers
31,Nebraska,473,127,84,43,0,0,43,8,7,1,0,0,1,47-3000,"Helpers, Construction Trades"
31,Nebraska,474,2920,2803,117,0,0,98,171,167,4,0,0,2,47-4000,Other Construction and Related Workers
31,Nebraska,475,578,505,73,0,0,73,44,43,1,0,0,1,47-5000,Extraction Workers
31,Nebraska,491,1479,1428,51,9,0,42,105,103,2,1,0,1,49-1000,"Supervisors of Installation, Maintenance, and Repair Workers"
31,Nebraska,492,3174,3050,124,0,0,0,156,152,4,0,0,0,49-2000,"Electrical and Electronic Equipment Mechanics, Installers, and Repairers"
31,Nebraska,493,14572,14009,563,61,0,172,838,821,17,4,0,5,49-3000,"Vehicle and Mobile Equipment Mechanics, Installers, and Repairers"
31,Nebraska,499,13660,12984,676,39,0,347,805,775,30,2,0,13,49-9000,"Other Installation, Maintenance, and Repair Occupations"
31,Nebraska,511,7016,5631,1385,208,181,582,340,309,31,7,2,11,51-1000,Supervisors of Production Workers
31,Nebraska,512,6337,5296,1041,78,0,509,351,313,38,2,0,16,51-2000,Assemblers and Fabricators
31,Nebraska,513,12340,5516,6824,952,28,2972,439,273,166,30,1,75,51-3000,Food Processing Workers
31,Nebraska,514,13398,11412,1986,60,0,590,758,701,57,4,1,17,51-4000,Metal Workers and Plastic Workers
31,Nebraska,5151,1081,1043,38,0,0,17,58,55,3,0,0,1,51-5100,Printing Workers
31,Nebraska,516,1837,1235,602,98,0,258,136,107,29,3,0,12,51-6000,"Textile, Apparel, and Furnishings Workers"
31,Nebraska,517,562,502,60,0,0,37,33,30,3,0,0,2,51-7000,Woodworkers
31,Nebraska,518,1787,1754,33,17,0,16,103,101,2,1,0,1,51-8000,Plant and System Operators
31,Nebraska,519,20652,14821,5831,466,143,2075,1069,902,167,16,2,69,51-9000,Other Production Occupations
31,Nebraska,531,1496,1147,349,86,0,200,76,68,8,2,0,4,53-1000,Supervisors of Transportation and Material Moving Workers
31,Nebraska,532,896,816,80,0,0,0,43,41,2,0,0,0,53-2000,Air Transportation Workers
31,Nebraska,533,26796,24985,1811,322,55,754,1595,1537,58,5,2,25,53-3000,Motor Vehicle Operators
31,Nebraska,534,3286,3254,32,0,0,0,175,174,1,0,0,0,53-4000,Rail Transportation Workers
31,Nebraska,535,72,72,0,0,0,0,3,3,0,0,0,0,53-5000,Water Transportation Workers
31,Nebraska,536,1038,943,95,0,0,95,79,74,5,0,2,3,53-6000,Other Transportation Workers
31,Nebraska,537,36128,30244,5884,1199,0,2709,2010,1820,190,35,1,78,53-7000,Material Moving Workers
32,Nevada,111,16901,13610,3291,155,180,717,939,771,168,7,8,28,11-1000,Top Executives
32,Nevada,112,8376,7439,937,13,51,40,471,417,54,1,3,4,11-2000,"Advertising, Marketing, Promotions, Public Relations, and Sales Managers"
32,Nevada,113,17988,15096,2892,143,147,824,1041,875,166,6,9,41,11-3000,Operations Specialties Managers
32,Nevada,119,67415,55057,12358,871,343,3912,3746,3142,604,41,23,161,11-9000,Other Management Occupations
32,Nevada,131,32369,28280,4089,278,222,1012,1825,1590,235,15,11,48,13-1000,Business Operations Specialists
32,Nevada,132,20519,16828,3691,119,114,449,1168,970,198,8,13,17,13-2000,Financial Specialists
32,Nevada,1512,25118,20422,4696,34,171,376,1393,1151,242,2,9,21,15-1200,Computer Occupations
32,Nevada,152,907,615,292,93,37,16,59,44,15,1,1,1,15-2000,Mathematical Science Occupations
32,Nevada,171,873,811,62,0,0,0,52,45,7,0,0,0,17-1000,"Architects, Surveyors, and Cartographers"
32,Nevada,172,9838,8391,1447,57,82,361,562,479,83,3,3,16,17-2000,Engineers
32,Nevada,173,5271,4407,864,94,24,267,288,244,44,5,2,14,17-3000,"Drafters, Engineering Technicians, and Mapping Technicians"
32,Nevada,191,917,836,81,0,0,0,57,50,7,0,0,0,19-1000,Life Scientists
32,Nevada,192,2283,1828,455,0,8,17,139,111,28,0,2,1,19-2000,Physical Scientists
32,Nevada,193,1248,1133,115,0,0,0,71,66,5,0,0,0,19-3000,Social Scientists and Related Workers
32,Nevada,194,2036,1746,290,0,0,44,134,113,21,0,1,3,19-4000,"Life, Physical, and Social Science Technicians"
32,Nevada,195,483,457,26,0,0,0,31,26,5,0,0,1,19-5000,Occupational Health and Safety Specialists and Technicians
32,Nevada,211,12309,10828,1481,242,56,590,701,631,70,9,3,23,21-1000,"Counselors, Social Workers, and Other Community and Social Service Specialists"
32,Nevada,212,1953,1487,466,0,41,95,116,97,19,0,1,6,21-2000,Religious Workers
32,Nevada,231,7088,6656,432,0,0,88,432,404,28,0,0,6,23-1000,"Lawyers, Judges, and Related Workers"
32,Nevada,232,4408,3853,555,0,29,353,261,225,36,0,3,16,23-2000,Legal Support Workers
32,Nevada,251,5852,4666,1186,34,24,201,361,290,71,3,2,9,25-1000,Postsecondary Teachers
32,Nevada,252,38712,35017,3695,207,182,739,2316,2110,206,10,10,40,25-2000,"Preschool, Elementary, Middle, Secondary, and Special Education Teachers"
32,Nevada,253,5899,5368,531,34,8,103,365,324,41,2,1,9,25-3000,Other Teachers and Instructors
32,Nevada,254,1499,1296,203,19,0,41,99,89,10,1,0,2,25-4000,"Librarians, Curators, and Archivists"
32,Nevada,259,7543,5590,1953,103,55,697,463,359,104,7,4,41,25-9000,Other Educational Instruction and Library Occupations
32,Nevada,271,8668,7003,1665,85,80,427,484,398,86,3,5,20,27-1000,Art and Design Workers
32,Nevada,272,9708,8093,1615,31,193,194,536,452,84,2,8,10,27-2000,"Entertainers and Performers, Sports and Related Workers"
32,Nevada,273,5628,5029,599,0,97,201,335,293,42,1,5,13,27-3000,Media and Communication Workers
32,Nevada,274,4282,3737,545,0,49,181,222,189,33,0,3,7,27-4000,Media and Communication Equipment Workers
32,Nevada,291,39699,28995,10704,129,182,593,2168,1593,575,7,13,30,29-1000,Healthcare Diagnosing or Treating Practitioners
32,Nevada,292,18973,15760,3213,14,35,649,987,822,165,1,3,23,29-2000,Health Technologists and Technicians
32,Nevada,299,510,465,45,0,20,0,30,28,2,0,1,0,29-9000,Other Healthcare Practitioners and Technical Occupations
32,Nevada,3111,15445,10983,4462,515,155,906,832,607,225,14,8,45,31-1100,"Home Health and Personal Care Aides; and Nursing Assistants, Orderlies, and Psychiatric Aides"
32,Nevada,312,633,525,108,0,0,56,40,33,7,0,0,2,31-2000,Occupational Therapy and Physical Therapist Assistants and Aides
32,Nevada,319,15565,12585,2980,408,156,795,779,621,158,16,12,42,31-9000,Other Healthcare Support Occupations
32,Nevada,331,2862,2621,241,36,15,127,195,184,11,2,1,4,33-1000,Supervisors of Protective Service Workers
32,Nevada,332,2563,2525,38,0,0,0,159,155,4,0,0,0,33-2000,Firefighting and Prevention Workers
32,Nevada,333,10884,10250,634,53,0,99,596,564,32,2,1,7,33-3000,Law Enforcement Workers
32,Nevada,339,23863,20935,2928,131,52,501,1236,1099,137,5,5,29,33-9000,Other Protective Service Workers
32,Nevada,351,14565,9167,5398,510,143,2470,674,454,220,18,8,86,35-1000,Supervisors of Food Preparation and Serving Workers
32,Nevada,352,46748,22208,24540,3383,712,14985,2257,1245,1012,115,23,590,35-2000,Cooks and Food Preparation Workers
32,Nevada,353,55225,39993,15232,1167,794,5709,2759,2042,717,57,33,237,35-3000,Food and Beverage Serving Workers
32,Nevada,359,20128,10936,9192,1687,287,4429,1041,609,432,62,10,211,35-9000,Other Food Preparation and Serving Related Workers
32,Nevada,371,4107,2529,1578,242,58,877,200,131,69,11,3,39,37-1000,Supervisors of Building and Grounds Cleaning and Maintenance Workers
32,Nevada,372,60218,21987,38231,5210,1551,21850,2971,1267,1704,198,56,960,37-2000,Building Cleaning and Pest Control Workers
32,Nevada,373,10927,4213,6714,1067,90,5403,532,272,260,41,4,208,37-3000,Grounds Maintenance Workers
32,Nevada,391,6233,4151,2082,64,90,195,332,241,91,5,3,12,39-1000,Supervisors of Personal Care and Service Workers
32,Nevada,392,3620,3386,234,24,0,116,194,182,12,1,0,4,39-2000,Animal Care and Service Workers
32,Nevada,393,24999,13840,11159,651,233,1193,1339,786,553,17,12,54,39-3000,Entertainment Attendants and Related Workers
32,Nevada,394,276,276,0,0,0,0,11,11,0,0,0,0,39-4000,Funeral Service Workers
32,Nevada,395,13349,9451,3898,81,86,955,657,477,180,5,5,36,39-5000,Personal Appearance Workers
32,Nevada,396,5769,3131,2638,235,64,808,260,151,109,6,5,29,39-6000,"Baggage Porters, Bellhops, and Concierges"
32,Nevada,397,590,467,123,0,15,37,52,36,16,0,2,1,39-7000,Tour and Travel Guides
32,Nevada,399,14002,11488,2514,352,117,672,831,695,136,12,7,38,39-9000,Other Personal Care and Service Workers
32,Nevada,411,42215,33451,8764,640,210,2483,2110,1712,398,28,15,109,41-1000,Supervisors of Sales Workers
32,Nevada,412,70229,52568,17661,1155,914,6172,3939,3056,883,45,39,294,41-2000,Retail Sales Workers
32,Nevada,413,13198,10962,2236,250,51,462,696,594,102,11,3,21,41-3000,"Sales Representatives, Services"
32,Nevada,414,8775,7646,1129,171,107,370,482,425,57,6,3,19,41-4000,"Sales Representatives, Wholesale and Manufacturing"
32,Nevada,419,15269,11816,3453,152,249,1050,908,711,197,9,12,49,41-9000,Other Sales and Related Workers
32,Nevada,431,13283,11805,1478,147,108,390,757,669,88,5,9,22,43-1000,Supervisors of Office and Administrative Support Workers
32,Nevada,432,1021,958,63,46,0,17,69,63,6,3,0,1,43-2000,Communications Equipment Operators
32,Nevada,433,19634,16253,3381,377,206,853,1130,958,172,14,11,37,43-3000,Financial Clerks
32,Nevada,434,61495,51256,10239,1017,464,3308,3482,2893,589,53,28,177,43-4000,Information and Record Clerks
32,Nevada,435,17066,13600,3466,435,186,1324,968,808,160,14,7,61,43-5000,"Material Recording, Scheduling, Dispatching, and Distributing Workers"
32,Nevada,436,19153,16394,2759,199,81,916,1260,1083,177,9,5,60,43-6000,Secretaries and Administrative Assistants
32,Nevada,439,22756,19270,3486,312,117,950,1346,1159,187,13,7,53,43-9000,Other Office and Administrative Support Workers
32,Nevada,451,236,221,15,0,0,15,16,15,1,0,0,1,45-1000,"Supervisors of Farming, Fishing, and Forestry Workers"
32,Nevada,452,2557,1464,1093,32,91,933,169,116,53,4,2,44,45-2000,Agricultural Workers
32,Nevada,453,22,22,0,0,0,0,5,5,0,0,0,0,45-3000,Fishing and Hunting Workers
32,Nevada,454,71,14,57,14,0,15,8,5,3,1,0,1,45-4000,"Forest, Conservation, and Logging Workers"
32,Nevada,471,7769,5333,2436,239,14,1966,397,299,98,8,1,76,47-1000,Supervisors of Construction and Extraction Workers
32,Nevada,472,63328,34659,28669,3404,418,23171,3028,1902,1126,119,21,890,47-2000,Construction Trades Workers
32,Nevada,473,329,107,222,66,26,108,16,10,6,1,1,3,47-3000,"Helpers, Construction Trades"
32,Nevada,474,2873,2373,500,59,0,370,154,134,20,2,0,13,47-4000,Other Construction and Related Workers
32,Nevada,475,4198,3809,389,0,0,352,189,165,24,1,0,21,47-5000,Extraction Workers
32,Nevada,491,2057,1810,247,0,12,170,127,116,11,0,1,6,49-1000,"Supervisors of Installation, Maintenance, and Repair Workers"
32,Nevada,492,4274,3483,791,103,0,395,234,197,37,4,0,14,49-2000,"Electrical and Electronic Equipment Mechanics, Installers, and Repairers"
32,Nevada,493,15565,12009,3556,701,199,1912,783,622,161,22,10,77,49-3000,"Vehicle and Mobile Equipment Mechanics, Installers, and Repairers"
32,Nevada,499,19735,14961,4774,426,139,2673,1002,803,199,15,7,104,49-9000,"Other Installation, Maintenance, and Repair Occupations"
32,Nevada,511,4351,3386,965,91,0,634,225,173,52,6,0,36,51-1000,Supervisors of Production Workers
32,Nevada,512,5195,3334,1861,422,64,862,255,176,79,15,4,39,51-2000,Assemblers and Fabricators
32,Nevada,513,5408,2770,2638,321,57,1716,270,159,111,12,3,65,51-3000,Food Processing Workers
32,Nevada,514,5940,4080,1860,244,0,1365,288,216,72,10,1,47,51-4000,Metal Workers and Plastic Workers
32,Nevada,5151,1922,1445,477,21,28,275,106,87,19,1,1,12,51-5100,Printing Workers
32,Nevada,516,5134,1945,3189,452,43,2086,282,119,163,23,3,106,51-6000,"Textile, Apparel, and Furnishings Workers"
32,Nevada,517,684,404,280,56,16,149,48,35,13,3,1,6,51-7000,Woodworkers
32,Nevada,518,3232,2520,712,59,14,265,179,145,34,4,1,12,51-8000,Plant and System Operators
32,Nevada,519,17633,11823,5810,913,97,3098,908,636,272,31,6,139,51-9000,Other Production Occupations
32,Nevada,531,2396,1943,453,0,50,90,109,93,16,0,2,4,53-1000,Supervisors of Transportation and Material Moving Workers
32,Nevada,532,5071,4515,556,10,25,0,275,245,30,1,2,0,53-2000,Air Transportation Workers
32,Nevada,533,45693,32461,13232,1108,452,3806,2335,1708,627,51,24,180,53-3000,Motor Vehicle Operators
32,Nevada,534,254,202,52,14,0,0,22,19,3,1,0,0,53-4000,Rail Transportation Workers
32,Nevada,535,87,51,36,0,0,0,8,5,3,0,0,0,53-5000,Water Transportation Workers
32,Nevada,536,3680,2926,754,50,69,250,182,147,35,4,5,7,53-6000,Other Transportation Workers
32,Nevada,537,54759,39432,15327,2071,286,9226,3001,2301,700,83,18,404,53-7000,Material Moving Workers
33,New Hampshire,111,11060,10690,370,0,38,0,590,563,27,0,4,0,11-1000,Top Executives
33,New Hampshire,112,5651,5247,404,0,0,0,292,271,21,0,0,0,11-2000,"Advertising, Marketing, Promotions, Public Relations, and Sales Managers"
33,New Hampshire,113,16083,15128,955,17,34,96,846,792,54,1,4,3,11-3000,Operations Specialties Managers
33,New Hampshire,119,42342,40112,2230,79,92,6,2400,2276,124,5,6,1,11-9000,Other Management Occupations
33,New Hampshire,131,22223,20997,1226,20,23,0,1262,1176,86,2,3,1,13-1000,Business Operations Specialists
33,New Hampshire,132,12710,12050,660,0,55,0,708,671,37,0,3,1,13-2000,Financial Specialists
33,New Hampshire,1512,26448,22015,4433,0,124,27,1330,1129,201,0,7,2,15-1200,Computer Occupations
33,New Hampshire,152,1288,1138,150,0,0,0,68,59,9,0,0,0,15-2000,Mathematical Science Occupations
33,New Hampshire,171,763,659,104,0,16,0,52,47,5,0,1,0,17-1000,"Architects, Surveyors, and Cartographers"
33,New Hampshire,172,13679,12657,1022,12,43,18,683,634,49,1,2,2,17-2000,Engineers
33,New Hampshire,173,4746,4541,205,0,0,0,267,254,13,0,0,0,17-3000,"Drafters, Engineering Technicians, and Mapping Technicians"
33,New Hampshire,191,838,780,58,0,0,0,45,42,3,0,0,0,19-1000,Life Scientists
33,New Hampshire,192,1751,1492,259,0,18,0,87,76,11,0,1,0,19-2000,Physical Scientists
33,New Hampshire,193,1165,1081,84,0,0,0,64,58,6,0,0,0,19-3000,Social Scientists and Related Workers
33,New Hampshire,194,1164,1141,23,0,10,0,88,82,6,1,1,0,19-4000,"Life, Physical, and Social Science Technicians"
33,New Hampshire,195,285,269,16,0,0,0,14,13,1,0,0,0,19-5000,Occupational Health and Safety Specialists and Technicians
33,New Hampshire,211,10315,9933,382,0,45,0,583,565,18,0,3,0,21-1000,"Counselors, Social Workers, and Other Community and Social Service Specialists"
33,New Hampshire,212,1275,1201,74,0,0,0,79,75,4,0,0,0,21-2000,Religious Workers
33,New Hampshire,231,2992,2791,201,48,32,0,168,158,10,1,1,0,23-1000,"Lawyers, Judges, and Related Workers"
33,New Hampshire,232,1635,1565,70,0,67,0,80,78,2,0,1,0,23-2000,Legal Support Workers
33,New Hampshire,251,5461,4360,1101,0,44,34,305,251,54,0,2,1,25-1000,Postsecondary Teachers
33,New Hampshire,252,26943,26098,845,11,70,16,1579,1531,48,1,6,2,25-2000,"Preschool, Elementary, Middle, Secondary, and Special Education Teachers"
33,New Hampshire,253,3770,3667,103,0,5,0,257,248,9,0,1,0,25-3000,Other Teachers and Instructors
33,New Hampshire,254,1562,1470,92,0,40,0,108,105,3,0,2,0,25-4000,"Librarians, Curators, and Archivists"
33,New Hampshire,259,7229,6861,368,0,0,1,434,414,20,0,0,1,25-9000,Other Educational Instruction and Library Occupations
33,New Hampshire,271,4565,4204,361,20,0,0,274,256,18,1,0,0,27-1000,Art and Design Workers
33,New Hampshire,272,1946,1847,99,0,0,0,195,185,10,0,1,0,27-2000,"Entertainers and Performers, Sports and Related Workers"
33,New Hampshire,273,2681,2358,323,0,0,0,171,155,16,0,0,0,27-3000,Media and Communication Workers
33,New Hampshire,274,972,903,69,0,0,0,71,68,3,0,0,0,27-4000,Media and Communication Equipment Workers
33,New Hampshire,291,33212,30694,2518,15,7,0,1752,1642,110,1,1,0,29-1000,Healthcare Diagnosing or Treating Practitioners
33,New Hampshire,292,12195,11523,672,0,47,40,633,596,37,0,3,1,29-2000,Health Technologists and Technicians
33,New Hampshire,299,500,443,57,0,0,0,33,32,1,0,0,0,29-9000,Other Healthcare Practitioners and Technical Occupations
33,New Hampshire,3111,13521,12074,1447,0,24,0,689,636,53,0,1,0,31-1100,"Home Health and Personal Care Aides; and Nursing Assistants, Orderlies, and Psychiatric Aides"
33,New Hampshire,312,562,562,0,0,0,0,29,29,0,0,0,0,31-2000,Occupational Therapy and Physical Therapist Assistants and Aides
33,New Hampshire,319,7167,6685,482,33,0,0,363,343,20,1,1,0,31-9000,Other Healthcare Support Occupations
33,New Hampshire,331,1312,1295,17,0,0,0,77,76,1,0,0,0,33-1000,Supervisors of Protective Service Workers
33,New Hampshire,332,1728,1728,0,0,0,0,92,92,0,0,0,0,33-2000,Firefighting and Prevention Workers
33,New Hampshire,333,4569,4431,138,0,32,0,258,253,5,0,1,0,33-3000,Law Enforcement Workers
33,New Hampshire,339,3315,3246,69,0,0,0,242,236,6,0,0,0,33-9000,Other Protective Service Workers
33,New Hampshire,351,5414,4819,595,64,83,97,262,234,28,1,4,1,35-1000,Supervisors of Food Preparation and Serving Workers
33,New Hampshire,352,12912,11983,929,0,187,103,738,688,50,0,5,4,35-2000,Cooks and Food Preparation Workers
33,New Hampshire,353,14783,14337,446,0,0,0,840,815,25,0,2,1,35-3000,Food and Beverage Serving Workers
33,New Hampshire,359,4972,4447,525,83,0,0,346,325,21,2,0,1,35-9000,Other Food Preparation and Serving Related Workers
33,New Hampshire,371,2471,2209,262,0,148,0,119,113,6,0,2,0,37-1000,Supervisors of Building and Grounds Cleaning and Maintenance Workers
33,New Hampshire,372,13769,12246,1523,0,467,105,830,756,74,0,18,2,37-2000,Building Cleaning and Pest Control Workers
33,New Hampshire,373,5947,5859,88,0,0,0,430,418,12,0,1,0,37-3000,Grounds Maintenance Workers
33,New Hampshire,391,332,332,0,0,0,0,14,14,0,0,0,0,39-1000,Supervisors of Personal Care and Service Workers
33,New Hampshire,392,1739,1718,21,0,0,0,123,121,2,0,0,0,39-2000,Animal Care and Service Workers
33,New Hampshire,393,1432,1412,20,0,0,0,124,123,1,0,0,0,39-3000,Entertainment Attendants and Related Workers
33,New Hampshire,394,87,87,0,0,0,0,5,5,0,0,0,0,39-4000,Funeral Service Workers
33,New Hampshire,395,5531,4666,865,0,0,0,265,240,25,0,0,0,39-5000,Personal Appearance Workers
33,New Hampshire,396,181,159,22,0,0,0,10,9,1,0,0,0,39-6000,"Baggage Porters, Bellhops, and Concierges"
33,New Hampshire,397,310,310,0,0,0,0,28,28,0,0,0,0,39-7000,Tour and Travel Guides
33,New Hampshire,399,8114,7574,540,69,42,0,658,617,41,3,2,0,39-9000,Other Personal Care and Service Workers
33,New Hampshire,411,22094,21087,1007,174,0,0,1103,1053,50,5,0,0,41-1000,Supervisors of Sales Workers
33,New Hampshire,412,28930,27913,1017,23,62,45,1856,1778,78,3,7,3,41-2000,Retail Sales Workers
33,New Hampshire,413,6985,6785,200,0,0,0,337,327,10,0,0,0,41-3000,"Sales Representatives, Services"
33,New Hampshire,414,7170,6839,331,0,0,81,376,361,15,0,0,2,41-4000,"Sales Representatives, Wholesale and Manufacturing"
33,New Hampshire,419,4912,4592,320,55,79,0,295,281,14,1,2,0,41-9000,Other Sales and Related Workers
33,New Hampshire,431,5323,5106,217,0,0,0,302,291,11,0,0,0,43-1000,Supervisors of Office and Administrative Support Workers
33,New Hampshire,432,292,280,12,0,0,0,16,15,1,0,0,0,43-2000,Communications Equipment Operators
33,New Hampshire,433,10205,9897,308,19,66,0,564,546,18,1,3,0,43-3000,Financial Clerks
33,New Hampshire,434,21531,20181,1350,50,113,177,1219,1145,74,6,6,4,43-4000,Information and Record Clerks
33,New Hampshire,435,10308,9822,486,0,19,56,546,522,24,0,1,1,43-5000,"Material Recording, Scheduling, Dispatching, and Distributing Workers"
33,New Hampshire,436,13077,12656,421,65,0,14,781,755,26,1,2,1,43-6000,Secretaries and Administrative Assistants
33,New Hampshire,439,12409,11558,851,38,63,0,725,680,45,2,3,0,43-9000,Other Office and Administrative Support Workers
33,New Hampshire,451,182,182,0,0,0,0,14,14,0,0,0,0,45-1000,"Supervisors of Farming, Fishing, and Forestry Workers"
33,New Hampshire,452,1182,1031,151,0,0,0,106,99,7,1,0,0,45-2000,Agricultural Workers
33,New Hampshire,453,313,275,38,38,0,0,14,13,1,1,0,0,45-3000,Fishing and Hunting Workers
33,New Hampshire,454,1048,704,344,0,26,0,64,52,12,0,1,0,45-4000,"Forest, Conservation, and Logging Workers"
33,New Hampshire,471,4914,4818,96,0,0,0,256,246,10,0,0,1,47-1000,Supervisors of Construction and Extraction Workers
33,New Hampshire,472,28733,27132,1601,395,102,315,1628,1563,65,14,4,8,47-2000,Construction Trades Workers
33,New Hampshire,473,18,18,0,0,0,0,4,4,0,0,0,0,47-3000,"Helpers, Construction Trades"
33,New Hampshire,474,1756,1664,92,0,16,0,120,116,4,0,1,0,47-4000,Other Construction and Related Workers
33,New Hampshire,475,449,449,0,0,0,0,24,24,0,0,0,0,47-5000,Extraction Workers
33,New Hampshire,491,1102,1054,48,0,0,0,56,53,3,0,0,0,49-1000,"Supervisors of Installation, Maintenance, and Repair Workers"
33,New Hampshire,492,2450,2326,124,0,0,0,114,107,7,0,0,0,49-2000,"Electrical and Electronic Equipment Mechanics, Installers, and Repairers"
33,New Hampshire,493,8662,8334,328,0,0,14,462,445,17,0,0,1,49-3000,"Vehicle and Mobile Equipment Mechanics, Installers, and Repairers"
33,New Hampshire,499,9548,9207,341,40,70,25,524,508,16,1,3,1,49-9000,"Other Installation, Maintenance, and Repair Occupations"
33,New Hampshire,511,4612,4250,362,0,35,62,222,204,18,0,2,2,51-1000,Supervisors of Production Workers
33,New Hampshire,512,6056,4762,1294,0,116,30,295,248,47,0,2,1,51-2000,Assemblers and Fabricators
33,New Hampshire,513,2207,2121,86,0,0,46,124,117,7,0,0,1,51-3000,Food Processing Workers
33,New Hampshire,514,11164,9796,1368,16,177,109,558,507,51,1,5,4,51-4000,Metal Workers and Plastic Workers
33,New Hampshire,5151,1323,1225,98,0,0,0,80,76,4,0,0,0,51-5100,Printing Workers
33,New Hampshire,516,1746,1534,212,0,42,0,124,103,21,0,3,0,51-6000,"Textile, Apparel, and Furnishings Workers"
33,New Hampshire,517,692,655,37,0,0,0,38,37,1,0,0,0,51-7000,Woodworkers
33,New Hampshire,518,991,991,0,0,0,0,63,63,0,0,0,0,51-8000,Plant and System Operators
33,New Hampshire,519,15304,13140,2164,17,213,216,785,711,74,1,11,6,51-9000,Other Production Occupations
33,New Hampshire,531,781,757,24,0,0,0,34,32,2,0,0,0,53-1000,Supervisors of Transportation and Material Moving Workers
33,New Hampshire,532,1825,1812,13,0,0,0,115,113,2,0,1,0,53-2000,Air Transportation Workers
33,New Hampshire,533,17504,16386,1118,55,73,0,909,857,52,2,4,0,53-3000,Motor Vehicle Operators
33,New Hampshire,534,341,341,0,0,0,0,10,10,0,0,0,0,53-4000,Rail Transportation Workers
33,New Hampshire,535,220,220,0,0,0,0,18,18,0,0,0,0,53-5000,Water Transportation Workers
33,New Hampshire,536,875,716,159,0,0,0,45,41,4,0,0,0,53-6000,Other Transportation Workers
33,New Hampshire,537,19612,17999,1613,77,86,41,1115,1052,63,4,6,2,53-7000,Material Moving Workers
34,New Jersey,111,68106,52825,15281,274,1486,134,3866,3070,796,13,70,3,11-1000,Top Executives
34,New Jersey,112,40603,34060,6543,107,822,179,2422,2078,344,5,44,5,11-2000,"Advertising, Marketing, Promotions, Public Relations, and Sales Managers"
34,New Jersey,113,114813,80967,33846,899,4232,696,6635,4761,1874,40,204,28,11-3000,Operations Specialties Managers
34,New Jersey,119,252457,187415,65042,3002,9278,1897,13821,10638,3183,98,373,75,11-9000,Other Management Occupations
34,New Jersey,131,155908,119082,36826,831,3923,392,9024,6985,2039,37,182,24,13-1000,Business Operations Specialists
34,New Jersey,132,117816,85631,32185,417,3045,299,6852,5078,1774,22,149,13,13-2000,Financial Specialists
34,New Jersey,1512,165634,84539,81095,793,2938,245,9300,4956,4344,29,138,14,15-1200,Computer Occupations
34,New Jersey,152,10693,6673,4020,16,88,0,603,377,226,1,4,0,15-2000,Mathematical Science Occupations
34,New Jersey,171,6730,4604,2126,18,277,24,401,276,125,2,13,1,17-1000,"Architects, Surveyors, and Cartographers"
34,New Jersey,172,46939,31338,15601,273,1264,142,2683,1843,840,15,55,5,17-2000,Engineers
34,New Jersey,173,13981,10133,3848,265,698,57,819,627,192,9,34,3,17-3000,"Drafters, Engineering Technicians, and Mapping Technicians"
34,New Jersey,191,8407,5176,3231,0,110,0,510,314,196,0,7,0,19-1000,Life Scientists
34,New Jersey,192,16992,9260,7732,61,202,25,986,558,428,5,12,1,19-2000,Physical Scientists
34,New Jersey,193,8445,7258,1187,0,182,41,521,448,73,0,12,3,19-3000,Social Scientists and Related Workers
34,New Jersey,194,8901,6402,2499,28,399,118,578,433,145,1,21,4,19-4000,"Life, Physical, and Social Science Technicians"
34,New Jersey,195,1372,1055,317,0,87,19,91,73,18,0,4,1,19-5000,Occupational Health and Safety Specialists and Technicians
34,New Jersey,211,60073,50812,9261,511,1700,125,3261,2806,455,22,82,7,21-1000,"Counselors, Social Workers, and Other Community and Social Service Specialists"
34,New Jersey,212,9028,6182,2846,139,470,45,665,434,231,7,38,3,21-2000,Religious Workers
34,New Jersey,231,39178,34735,4443,101,291,12,2288,2066,222,4,15,2,23-1000,"Lawyers, Judges, and Related Workers"
34,New Jersey,232,17326,14647,2679,30,381,14,998,853,145,3,20,3,23-2000,Legal Support Workers
34,New Jersey,251,28971,19314,9657,42,1065,106,1831,1250,581,4,48,5,25-1000,Postsecondary Teachers
34,New Jersey,252,176507,155532,20975,926,4147,370,10890,9695,1195,43,196,11,25-2000,"Preschool, Elementary, Middle, Secondary, and Special Education Teachers"
34,New Jersey,253,22010,17679,4331,176,759,86,1489,1219,270,7,32,4,25-3000,Other Teachers and Instructors
34,New Jersey,254,6715,5680,1035,82,108,19,465,396,69,1,6,1,25-4000,"Librarians, Curators, and Archivists"
34,New Jersey,259,52535,42014,10521,383,2572,246,3119,2568,551,24,114,16,25-9000,Other Educational Instruction and Library Occupations
34,New Jersey,271,31280,24037,7243,225,838,254,1918,1491,427,10,46,11,27-1000,Art and Design Workers
34,New Jersey,272,19187,16414,2773,40,528,148,1347,1179,168,1,27,5,27-2000,"Entertainers and Performers, Sports and Related Workers"
34,New Jersey,273,25034,21610,3424,164,373,22,1639,1420,219,5,24,1,27-3000,Media and Communication Workers
34,New Jersey,274,9333,7793,1540,19,301,28,569,484,85,1,13,2,27-4000,Media and Communication Equipment Workers
34,New Jersey,291,171936,120499,51437,431,3570,167,9706,7067,2639,22,169,9,29-1000,Healthcare Diagnosing or Treating Practitioners
34,New Jersey,292,73076,51705,21371,444,2343,738,3765,2760,1005,21,106,14,29-2000,Health Technologists and Technicians
34,New Jersey,299,2011,1721,290,0,17,0,128,108,20,0,2,0,29-9000,Other Healthcare Practitioners and Technical Occupations
34,New Jersey,3111,77131,38400,38731,1527,5297,679,3575,1978,1597,60,237,27,31-1100,"Home Health and Personal Care Aides; and Nursing Assistants, Orderlies, and Psychiatric Aides"
34,New Jersey,312,3298,2574,724,52,0,48,192,152,40,1,0,2,31-2000,Occupational Therapy and Physical Therapist Assistants and Aides
34,New Jersey,319,39968,29758,10210,282,2810,420,2040,1546,494,16,108,15,31-9000,Other Healthcare Support Occupations
34,New Jersey,331,8954,8301,653,0,201,0,504,472,32,0,8,0,33-1000,Supervisors of Protective Service Workers
34,New Jersey,332,6811,6332,479,0,74,0,349,329,20,0,3,0,33-2000,Firefighting and Prevention Workers
34,New Jersey,333,41920,38921,2999,249,540,107,2169,2024,145,11,27,4,33-3000,Law Enforcement Workers
34,New Jersey,339,42296,34899,7397,304,1186,144,2433,2116,317,8,49,9,33-9000,Other Protective Service Workers
34,New Jersey,351,23400,14678,8722,850,1536,1088,1185,811,374,25,63,35,35-1000,Supervisors of Food Preparation and Serving Workers
34,New Jersey,352,64268,31392,32876,6536,4864,9258,3225,2018,1207,182,188,290,35-2000,Cooks and Food Preparation Workers
34,New Jersey,353,86630,65967,20663,2281,4890,2275,4999,4043,956,77,215,73,35-3000,Food and Beverage Serving Workers
34,New Jersey,359,22602,15758,6844,1453,1123,1527,1458,1147,311,44,60,57,35-9000,Other Food Preparation and Serving Related Workers
34,New Jersey,371,9959,6156,3803,784,1127,590,488,330,158,35,39,18,37-1000,Supervisors of Building and Grounds Cleaning and Maintenance Workers
34,New Jersey,372,100218,44090,56128,9287,17971,6829,4960,2599,2361,337,754,235,37-2000,Building Cleaning and Pest Control Workers
34,New Jersey,373,28587,15836,12751,4598,1099,5155,1480,1054,426,138,45,152,37-3000,Grounds Maintenance Workers
34,New Jersey,391,3534,2171,1363,45,258,0,171,122,49,1,7,0,39-1000,Supervisors of Personal Care and Service Workers
34,New Jersey,392,7159,6480,679,118,266,67,449,408,41,6,13,2,39-2000,Animal Care and Service Workers
34,New Jersey,393,11665,8615,3050,98,274,49,800,640,160,3,18,2,39-3000,Entertainment Attendants and Related Workers
34,New Jersey,394,1167,1145,22,0,12,0,68,65,3,0,1,0,39-4000,Funeral Service Workers
34,New Jersey,395,36592,23757,12835,988,1979,429,1847,1233,614,34,90,23,39-5000,Personal Appearance Workers
34,New Jersey,396,3441,2124,1317,129,81,25,160,106,54,5,5,1,39-6000,"Baggage Porters, Bellhops, and Concierges"
34,New Jersey,397,1002,811,191,0,147,0,70,60,10,0,3,0,39-7000,Tour and Travel Guides
34,New Jersey,399,56555,41857,14698,1349,3858,605,3945,3162,783,58,193,28,39-9000,Other Personal Care and Service Workers
34,New Jersey,411,122031,89789,32242,1134,4243,1077,6502,4973,1529,43,173,44,41-1000,Supervisors of Sales Workers
34,New Jersey,412,174419,132735,41684,3259,6844,2793,10525,8414,2111,122,331,123,41-2000,Retail Sales Workers
34,New Jersey,413,55463,46572,8891,354,1359,206,3163,2673,490,11,58,8,41-3000,"Sales Representatives, Services"
34,New Jersey,414,38578,31641,6937,487,1091,352,2198,1858,340,13,45,11,41-4000,"Sales Representatives, Wholesale and Manufacturing"
34,New Jersey,419,34233,27398,6835,235,1371,172,2044,1677,367,10,65,4,41-9000,Other Sales and Related Workers
34,New Jersey,431,43063,34390,8673,560,1693,300,2381,1931,450,19,79,13,43-1000,Supervisors of Office and Administrative Support Workers
34,New Jersey,432,1783,1477,306,0,103,0,95,82,13,0,4,0,43-2000,Communications Equipment Operators
34,New Jersey,433,68431,52786,15645,770,2800,387,4013,3155,858,26,134,18,43-3000,Financial Clerks
34,New Jersey,434,131307,106021,25286,1541,5111,1380,7582,6269,1313,67,258,52,43-4000,Information and Record Clerks
34,New Jersey,435,60779,44051,16728,1215,3758,697,3211,2451,760,43,161,30,43-5000,"Material Recording, Scheduling, Dispatching, and Distributing Workers"
34,New Jersey,436,93528,79390,14138,952,3328,388,5790,4957,833,39,164,18,43-6000,Secretaries and Administrative Assistants
34,New Jersey,439,77144,61709,15435,905,4047,306,4656,3780,876,38,182,14,43-9000,Other Office and Administrative Support Workers
34,New Jersey,451,396,317,79,0,0,70,22,17,5,0,0,4,45-1000,"Supervisors of Farming, Fishing, and Forestry Workers"
34,New Jersey,452,6329,2764,3565,408,340,2245,389,217,172,26,9,114,45-2000,Agricultural Workers
34,New Jersey,453,774,674,100,0,0,0,66,59,7,0,0,0,45-3000,Fishing and Hunting Workers
34,New Jersey,454,261,235,26,0,0,11,24,22,2,0,0,1,45-4000,"Forest, Conservation, and Logging Workers"
34,New Jersey,471,18033,14307,3726,801,608,391,980,820,160,20,30,15,47-1000,Supervisors of Construction and Extraction Workers
34,New Jersey,472,159439,93834,65605,16240,17958,12240,7786,5455,2331,454,607,368,47-2000,Construction Trades Workers
34,New Jersey,473,593,346,247,57,80,82,31,24,7,1,2,2,47-3000,"Helpers, Construction Trades"
34,New Jersey,474,9431,7217,2214,395,688,264,518,422,96,15,23,7,47-4000,Other Construction and Related Workers
34,New Jersey,475,1051,1004,47,4,24,0,59,56,3,1,1,0,47-5000,Extraction Workers
34,New Jersey,491,6395,4859,1536,0,420,140,325,270,55,0,14,4,49-1000,"Supervisors of Installation, Maintenance, and Repair Workers"
34,New Jersey,492,13800,10374,3426,238,848,47,719,587,132,8,31,3,49-2000,"Electrical and Electronic Equipment Mechanics, Installers, and Repairers"
34,New Jersey,493,41135,28748,12387,1599,3054,1471,2007,1542,465,54,103,40,49-3000,"Vehicle and Mobile Equipment Mechanics, Installers, and Repairers"
34,New Jersey,499,48414,36285,12129,1272,2878,852,2565,2043,522,46,111,30,49-9000,"Other Installation, Maintenance, and Repair Occupations"
34,New Jersey,511,16863,10598,6265,851,1199,417,903,612,291,28,57,19,51-1000,Supervisors of Production Workers
34,New Jersey,512,12850,6693,6157,705,1604,674,734,429,305,29,71,29,51-2000,Assemblers and Fabricators
34,New Jersey,513,14385,7492,6893,1084,1209,1410,718,432,286,40,48,39,51-3000,Food Processing Workers
34,New Jersey,514,17988,10048,7940,1242,2136,611,961,617,344,45,99,23,51-4000,Metal Workers and Plastic Workers
34,New Jersey,5151,6051,4254,1797,168,482,241,308,223,85,6,20,11,51-5100,Printing Workers
34,New Jersey,516,11446,3414,8032,1080,1636,1296,585,216,369,38,74,49,51-6000,"Textile, Apparel, and Furnishings Workers"
34,New Jersey,517,1781,993,788,94,158,158,93,64,29,1,7,4,51-7000,Woodworkers
34,New Jersey,518,6807,5349,1458,95,311,56,374,308,66,3,12,3,51-8000,Plant and System Operators
34,New Jersey,519,71895,35096,36799,4758,8300,4537,3631,2061,1570,168,367,170,51-9000,Other Production Occupations
34,New Jersey,531,8626,5989,2637,194,669,50,444,333,111,8,29,2,53-1000,Supervisors of Transportation and Material Moving Workers
34,New Jersey,532,5446,4325,1121,51,180,42,294,242,52,2,8,1,53-2000,Air Transportation Workers
34,New Jersey,533,132125,76037,56088,5717,13149,2203,6209,4032,2177,188,523,81,53-3000,Motor Vehicle Operators
34,New Jersey,534,2367,1971,396,0,40,85,143,123,20,0,3,3,53-4000,Rail Transportation Workers
34,New Jersey,535,1591,1331,260,0,0,32,82,70,12,0,0,1,53-5000,Water Transportation Workers
34,New Jersey,536,12960,9103,3857,103,723,243,641,492,149,2,30,5,53-6000,Other Transportation Workers
34,New Jersey,537,151186,90481,60705,9989,13182,8579,7698,5287,2411,323,529,336,53-7000,Material Moving Workers
35,New Mexico,111,9440,8911,529,0,0,260,508,484,24,0,0,9,11-1000,Top Executives
35,New Mexico,112,2926,2906,20,0,0,8,159,155,4,0,1,1,11-2000,"Advertising, Marketing, Promotions, Public Relations, and Sales Managers"
35,New Mexico,113,13241,12373,868,95,43,380,676,645,31,4,1,14,11-3000,Operations Specialties Managers
35,New Mexico,119,50152,44802,5350,127,164,3464,2656,2440,216,4,7,129,11-9000,Other Management Occupations
35,New Mexico,131,19192,18472,720,27,38,275,1023,980,43,1,3,16,13-1000,Business Operations Specialists
35,New Mexico,132,11854,11153,701,20,35,303,701,654,47,1,4,12,13-2000,Financial Specialists
35,New Mexico,1512,15692,14401,1291,0,44,274,856,787,69,0,4,13,15-1200,Computer Occupations
35,New Mexico,152,1000,910,90,0,0,0,59,52,7,0,0,0,15-2000,Mathematical Science Occupations
35,New Mexico,171,1107,1097,10,0,0,10,53,52,1,0,0,1,17-1000,"Architects, Surveyors, and Cartographers"
35,New Mexico,172,11736,10396,1340,35,158,292,612,550,62,2,6,12,17-2000,Engineers
35,New Mexico,173,5350,5008,342,0,18,213,258,243,15,0,1,6,17-3000,"Drafters, Engineering Technicians, and Mapping Technicians"
35,New Mexico,191,1746,1471,275,0,19,27,95,80,15,0,1,2,19-1000,Life Scientists
35,New Mexico,192,5730,4052,1678,0,75,69,306,231,75,0,3,3,19-2000,Physical Scientists
35,New Mexico,193,1613,1552,61,0,0,0,99,94,5,0,0,0,19-3000,Social Scientists and Related Workers
35,New Mexico,194,3464,3004,460,0,0,87,210,183,27,0,0,5,19-4000,"Life, Physical, and Social Science Technicians"
35,New Mexico,195,593,563,30,0,0,30,36,34,2,0,0,2,19-5000,Occupational Health and Safety Specialists and Technicians
35,New Mexico,211,13461,12652,809,0,78,282,714,679,35,0,5,15,21-1000,"Counselors, Social Workers, and Other Community and Social Service Specialists"
35,New Mexico,212,2716,2374,342,0,118,166,128,113,15,0,3,9,21-2000,Religious Workers
35,New Mexico,231,4854,4531,323,0,42,22,255,242,13,0,1,2,23-1000,"Lawyers, Judges, and Related Workers"
35,New Mexico,232,3163,2736,427,23,10,311,142,130,12,1,1,6,23-2000,Legal Support Workers
35,New Mexico,251,8419,6282,2137,91,179,421,452,362,90,1,9,15,25-1000,Postsecondary Teachers
35,New Mexico,252,31044,28597,2447,13,149,1035,1749,1616,133,1,9,44,25-2000,"Preschool, Elementary, Middle, Secondary, and Special Education Teachers"
35,New Mexico,253,3884,3651,233,0,75,71,279,259,20,0,5,4,25-3000,Other Teachers and Instructors
35,New Mexico,254,2179,2111,68,0,0,64,120,114,6,0,0,4,25-4000,"Librarians, Curators, and Archivists"
35,New Mexico,259,9517,8518,999,20,47,703,553,502,51,1,4,30,25-9000,Other Educational Instruction and Library Occupations
35,New Mexico,271,5712,5411,301,14,102,112,337,318,19,1,1,6,27-1000,Art and Design Workers
35,New Mexico,272,3189,2853,336,0,91,164,189,171,18,0,2,8,27-2000,"Entertainers and Performers, Sports and Related Workers"
35,New Mexico,273,4313,3758,555,14,52,356,237,215,22,1,3,9,27-3000,Media and Communication Workers
35,New Mexico,274,1720,1605,115,0,0,103,90,85,5,0,0,2,27-4000,Media and Communication Equipment Workers
35,New Mexico,291,32961,29610,3351,0,223,622,1608,1471,137,0,9,27,29-1000,Healthcare Diagnosing or Treating Practitioners
35,New Mexico,292,16358,15300,1058,0,194,239,733,689,44,0,4,15,29-2000,Health Technologists and Technicians
35,New Mexico,299,580,580,0,0,0,0,24,23,1,0,0,1,29-9000,Other Healthcare Practitioners and Technical Occupations
35,New Mexico,3111,25490,21797,3693,92,188,2793,1478,1325,153,4,7,117,31-1100,"Home Health and Personal Care Aides; and Nursing Assistants, Orderlies, and Psychiatric Aides"
35,New Mexico,312,573,555,18,0,0,18,34,32,2,0,1,1,31-2000,Occupational Therapy and Physical Therapist Assistants and Aides
35,New Mexico,319,9421,8582,839,29,20,414,458,425,33,2,1,13,31-9000,Other Healthcare Support Occupations
35,New Mexico,331,2236,2217,19,0,0,0,128,126,2,0,0,1,33-1000,Supervisors of Protective Service Workers
35,New Mexico,332,2992,2905,87,0,0,39,169,165,4,0,0,2,33-2000,Firefighting and Prevention Workers
35,New Mexico,333,9872,9566,306,0,9,158,432,420,12,0,1,7,33-3000,Law Enforcement Workers
35,New Mexico,339,9877,9137,740,14,12,346,553,523,30,2,1,11,33-9000,Other Protective Service Workers
35,New Mexico,351,5273,4514,759,0,0,574,257,217,40,0,0,28,35-1000,Supervisors of Food Preparation and Serving Workers
35,New Mexico,352,22756,16470,6286,186,25,5592,1210,979,231,6,1,201,35-2000,Cooks and Food Preparation Workers
35,New Mexico,353,22176,19418,2758,142,25,2020,1065,946,119,6,1,80,35-3000,Food and Beverage Serving Workers
35,New Mexico,359,5700,4196,1504,20,0,1117,358,308,50,1,0,40,35-9000,Other Food Preparation and Serving Related Workers
35,New Mexico,371,2131,1872,259,0,0,250,98,88,10,0,0,9,37-1000,Supervisors of Building and Grounds Cleaning and Maintenance Workers
35,New Mexico,372,25267,17337,7930,754,47,6966,1472,1144,328,18,2,294,37-2000,Building Cleaning and Pest Control Workers
35,New Mexico,373,7849,5743,2106,99,19,1943,432,354,78,6,1,67,37-3000,Grounds Maintenance Workers
35,New Mexico,391,715,680,35,0,0,0,38,36,2,0,0,0,39-1000,Supervisors of Personal Care and Service Workers
35,New Mexico,392,2092,1772,320,0,0,310,126,110,16,0,0,13,39-2000,Animal Care and Service Workers
35,New Mexico,393,2022,1882,140,0,0,57,134,121,13,0,0,3,39-3000,Entertainment Attendants and Related Workers
35,New Mexico,394,281,281,0,0,0,0,18,18,0,0,0,0,39-4000,Funeral Service Workers
35,New Mexico,395,6158,5147,1011,7,22,223,267,227,40,1,2,9,39-5000,Personal Appearance Workers
35,New Mexico,396,279,245,34,0,0,34,9,8,1,0,0,1,39-6000,"Baggage Porters, Bellhops, and Concierges"
35,New Mexico,397,398,398,0,0,0,0,33,32,1,0,1,0,39-7000,Tour and Travel Guides
35,New Mexico,399,10142,9076,1066,44,0,803,603,552,51,2,1,34,39-9000,Other Personal Care and Service Workers
35,New Mexico,411,24004,21794,2210,62,67,1604,1082,1002,80,2,2,51,41-1000,Supervisors of Sales Workers
35,New Mexico,412,42579,38080,4499,30,80,3203,2203,2022,181,3,5,124,41-2000,Retail Sales Workers
35,New Mexico,413,5676,5090,586,0,15,413,245,231,14,0,1,10,41-3000,"Sales Representatives, Services"
35,New Mexico,414,5125,4649,476,0,0,368,260,239,21,0,0,16,41-4000,"Sales Representatives, Wholesale and Manufacturing"
35,New Mexico,419,5231,4815,416,69,0,146,272,247,25,2,1,10,41-9000,Other Sales and Related Workers
35,New Mexico,431,8600,8095,505,35,0,361,408,385,23,2,1,12,43-1000,Supervisors of Office and Administrative Support Workers
35,New Mexico,432,627,591,36,0,0,36,24,23,1,0,0,1,43-2000,Communications Equipment Operators
35,New Mexico,433,15469,14615,854,37,12,573,805,759,46,3,2,28,43-3000,Financial Clerks
35,New Mexico,434,33744,31914,1830,70,21,1340,1689,1593,96,5,4,59,43-4000,Information and Record Clerks
35,New Mexico,435,9686,8655,1031,75,39,647,502,462,40,3,2,22,43-5000,"Material Recording, Scheduling, Dispatching, and Distributing Workers"
35,New Mexico,436,17175,16360,815,0,99,584,1032,974,58,1,4,36,43-6000,Secretaries and Administrative Assistants
35,New Mexico,439,15627,14662,965,0,29,700,881,838,43,2,2,26,43-9000,Other Office and Administrative Support Workers
35,New Mexico,451,523,498,25,0,0,25,32,27,5,0,0,4,45-1000,"Supervisors of Farming, Fishing, and Forestry Workers"
35,New Mexico,452,5851,3095,2756,46,0,2679,389,281,108,4,0,101,45-2000,Agricultural Workers
35,New Mexico,453,98,98,0,0,0,0,3,3,0,0,0,0,45-3000,Fishing and Hunting Workers
35,New Mexico,454,366,332,34,0,0,34,28,26,2,0,0,2,45-4000,"Forest, Conservation, and Logging Workers"
35,New Mexico,471,5975,4961,1014,55,4,944,301,258,43,1,1,38,47-1000,Supervisors of Construction and Extraction Workers
35,New Mexico,472,39431,28098,11333,170,0,10988,2097,1713,384,6,1,372,47-2000,Construction Trades Workers
35,New Mexico,473,608,465,143,0,0,143,29,25,4,0,0,4,47-3000,"Helpers, Construction Trades"
35,New Mexico,474,2203,1925,278,0,0,278,133,123,10,0,0,9,47-4000,Other Construction and Related Workers
35,New Mexico,475,5559,4257,1302,0,21,1167,238,190,48,0,1,42,47-5000,Extraction Workers
35,New Mexico,491,1857,1708,149,0,0,149,84,78,6,0,0,6,49-1000,"Supervisors of Installation, Maintenance, and Repair Workers"
35,New Mexico,492,3229,2916,313,0,0,240,148,139,9,0,0,7,49-2000,"Electrical and Electronic Equipment Mechanics, Installers, and Repairers"
35,New Mexico,493,14392,12311,2081,0,0,1893,657,583,74,0,1,67,49-3000,"Vehicle and Mobile Equipment Mechanics, Installers, and Repairers"
35,New Mexico,499,13327,11709,1618,24,68,1221,602,536,66,2,3,49,49-9000,"Other Installation, Maintenance, and Repair Occupations"
35,New Mexico,511,2148,1732,416,0,0,366,113,98,15,0,0,13,51-1000,Supervisors of Production Workers
35,New Mexico,512,1685,1394,291,30,0,180,93,80,13,2,0,7,51-2000,Assemblers and Fabricators
35,New Mexico,513,3690,2830,860,64,0,796,168,138,30,3,0,26,51-3000,Food Processing Workers
35,New Mexico,514,5092,4321,771,30,17,642,277,246,31,1,1,25,51-4000,Metal Workers and Plastic Workers
35,New Mexico,5151,501,452,49,0,0,49,26,24,2,0,0,2,51-5100,Printing Workers
35,New Mexico,516,2189,1271,918,0,0,772,136,96,40,0,1,30,51-6000,"Textile, Apparel, and Furnishings Workers"
35,New Mexico,517,629,539,90,37,53,0,40,38,2,1,1,0,51-7000,Woodworkers
35,New Mexico,518,2295,2211,84,0,0,29,109,106,3,0,0,1,51-8000,Plant and System Operators
35,New Mexico,519,11074,9460,1614,127,0,1312,625,554,71,2,0,59,51-9000,Other Production Occupations
35,New Mexico,531,743,727,16,0,0,16,50,49,1,0,0,1,53-1000,Supervisors of Transportation and Material Moving Workers
35,New Mexico,532,1806,1715,91,0,0,0,76,68,8,0,0,0,53-2000,Air Transportation Workers
35,New Mexico,533,23422,19259,4163,96,30,3169,1200,1048,152,5,2,118,53-3000,Motor Vehicle Operators
35,New Mexico,534,959,959,0,0,0,0,44,43,1,1,0,0,53-4000,Rail Transportation Workers
35,New Mexico,535,18,18,0,0,0,0,6,4,2,0,0,1,53-5000,Water Transportation Workers
35,New Mexico,536,1479,1314,165,0,0,29,78,74,4,0,0,1,53-6000,Other Transportation Workers
35,New Mexico,537,25125,21042,4083,136,45,3460,1365,1203,162,7,3,126,53-7000,Material Moving Workers
36,New York,111,124339,98504,25835,497,2705,617,6607,5350,1257,20,117,21,11-1000,Top Executives
36,New York,112,74408,61923,12485,404,1355,288,3836,3202,634,13,57,9,11-2000,"Advertising, Marketing, Promotions, Public Relations, and Sales Managers"
36,New York,113,183854,139301,44553,1262,5027,999,10194,7869,2325,53,253,45,11-3000,Operations Specialties Managers
36,New York,119,512813,398745,114068,5440,14127,4505,28234,22662,5572,223,634,159,11-9000,Other Management Occupations
36,New York,131,279942,223788,56154,1600,6374,1233,15182,12355,2827,68,302,44,13-1000,Business Operations Specialists
36,New York,132,227459,169145,58314,1011,5979,630,12329,9193,3136,43,315,34,13-2000,Financial Specialists
36,New York,1512,231931,165072,66859,1124,5638,704,13046,9416,3630,39,277,37,15-1200,Computer Occupations
36,New York,152,13442,9531,3911,0,162,16,781,569,212,0,10,1,15-2000,Mathematical Science Occupations
36,New York,171,20446,14612,5834,64,915,49,1047,767,280,3,39,3,17-1000,"Architects, Surveyors, and Cartographers"
36,New York,172,82081,63036,19045,264,1509,273,4802,3780,1022,14,78,11,17-2000,Engineers
36,New York,173,26253,20626,5627,268,1192,144,1671,1377,294,11,50,6,17-3000,"Drafters, Engineering Technicians, and Mapping Technicians"
36,New York,191,13556,8558,4998,71,238,57,799,520,279,3,13,2,19-1000,Life Scientists
36,New York,192,23339,15119,8220,97,513,23,1261,813,448,4,25,2,19-2000,Physical Scientists
36,New York,193,23617,19421,4196,61,479,41,1353,1132,221,4,20,2,19-3000,Social Scientists and Related Workers
36,New York,194,16379,12735,3644,251,387,165,1313,1079,234,8,26,10,19-4000,"Life, Physical, and Social Science Technicians"
36,New York,195,2662,2030,632,138,11,34,166,136,30,2,1,1,19-5000,Occupational Health and Safety Specialists and Technicians
36,New York,211,162463,133281,29182,1202,4094,809,9172,7698,1474,63,206,26,21-1000,"Counselors, Social Workers, and Other Community and Social Service Specialists"
36,New York,212,21066,15066,6000,403,713,103,1418,1035,383,10,36,5,21-2000,Religious Workers
36,New York,231,107404,93261,14143,150,876,485,5515,4830,685,7,47,12,23-1000,"Lawyers, Judges, and Related Workers"
36,New York,232,38934,32730,6204,329,1193,63,2196,1851,345,19,59,3,23-2000,Legal Support Workers
36,New York,251,88188,61421,26767,353,1685,254,5341,3783,1558,14,103,16,25-1000,Postsecondary Teachers
36,New York,252,355462,311088,44374,1542,5923,704,21499,19062,2437,68,311,37,25-2000,"Preschool, Elementary, Middle, Secondary, and Special Education Teachers"
36,New York,253,55209,44895,10314,320,1386,57,3841,3158,683,12,81,12,25-3000,Other Teachers and Instructors
36,New York,254,21410,18414,2996,64,192,17,1378,1193,185,6,12,1,25-4000,"Librarians, Curators, and Archivists"
36,New York,259,121836,96035,25801,1034,3483,859,7836,6370,1466,63,186,38,25-9000,Other Educational Instruction and Library Occupations
36,New York,271,100484,73270,27214,776,3124,1236,5528,4098,1430,38,156,45,27-1000,Art and Design Workers
36,New York,272,69768,58064,11704,161,1786,352,4287,3635,652,9,85,16,27-2000,"Entertainers and Performers, Sports and Related Workers"
36,New York,273,87611,72642,14969,354,1719,440,4797,3989,808,17,85,19,27-3000,Media and Communication Workers
36,New York,274,27670,22106,5564,137,969,160,1663,1355,308,8,43,8,27-4000,Media and Communication Equipment Workers
36,New York,291,391348,280982,110366,1414,8733,574,21950,16238,5712,62,406,27,29-1000,Healthcare Diagnosing or Treating Practitioners
36,New York,292,156732,114768,41964,1176,5231,709,8700,6626,2074,61,248,26,29-2000,Health Technologists and Technicians
36,New York,299,4705,3343,1362,39,297,0,262,201,61,1,10,0,29-9000,Other Healthcare Practitioners and Technical Occupations
36,New York,3111,313299,139551,173748,6470,17826,2220,15725,7987,7738,275,882,95,31-1100,"Home Health and Personal Care Aides; and Nursing Assistants, Orderlies, and Psychiatric Aides"
36,New York,312,8484,6543,1941,53,186,129,520,410,110,3,11,4,31-2000,Occupational Therapy and Physical Therapist Assistants and Aides
36,New York,319,76817,54780,22037,1283,3141,522,4084,3028,1056,49,149,19,31-9000,Other Healthcare Support Occupations
36,New York,331,18872,16708,2164,24,413,21,1216,1099,117,3,20,1,33-1000,Supervisors of Protective Service Workers
36,New York,332,18937,17749,1188,113,238,159,1028,983,45,3,10,2,33-2000,Firefighting and Prevention Workers
36,New York,333,111297,96749,14548,527,2109,150,6231,5550,681,25,106,8,33-3000,Law Enforcement Workers
36,New York,339,106121,79886,26235,1188,3585,385,6257,5039,1218,45,183,14,33-9000,Other Protective Service Workers
36,New York,351,72733,39999,32734,2013,3003,4629,3646,2209,1437,71,135,135,35-1000,Supervisors of Food Preparation and Serving Workers
36,New York,352,177420,101016,76404,10552,8087,19921,9777,6821,2956,315,315,583,35-2000,Cooks and Food Preparation Workers
36,New York,353,195884,138010,57874,5548,7757,8623,11632,8956,2676,183,337,266,35-3000,Food and Beverage Serving Workers
36,New York,359,55765,34800,20965,2046,2688,6304,3680,2829,851,74,114,173,35-9000,Other Food Preparation and Serving Related Workers
36,New York,371,17916,12341,5575,605,1415,223,995,746,249,22,64,10,37-1000,Supervisors of Building and Grounds Cleaning and Maintenance Workers
36,New York,372,286847,143630,143217,20421,30272,16575,15261,9261,6000,760,1280,620,37-2000,Building Cleaning and Pest Control Workers
36,New York,373,48013,31362,16651,8309,2527,2575,3244,2673,571,218,79,83,37-3000,Grounds Maintenance Workers
36,New York,391,6810,4450,2360,47,332,0,354,247,107,3,10,1,39-1000,Supervisors of Personal Care and Service Workers
36,New York,392,15051,12910,2141,74,654,297,935,838,97,4,24,7,39-2000,Animal Care and Service Workers
36,New York,393,19682,16653,3029,234,262,73,1493,1315,178,8,17,4,39-3000,Entertainment Attendants and Related Workers
36,New York,394,2201,2027,174,0,18,0,132,124,8,1,1,0,39-4000,Funeral Service Workers
36,New York,395,83620,42693,40927,961,4389,1151,4043,2251,1792,43,184,41,39-5000,Personal Appearance Workers
36,New York,396,20129,11158,8971,461,1805,323,835,485,350,18,54,12,39-6000,"Baggage Porters, Bellhops, and Concierges"
36,New York,397,3995,2965,1030,78,41,0,314,255,59,2,2,0,39-7000,Tour and Travel Guides
36,New York,399,152665,99492,53173,3823,8750,3261,10681,8024,2657,163,435,129,39-9000,Other Personal Care and Service Workers
36,New York,411,228282,175460,52822,2537,5925,2284,12431,9846,2585,99,294,90,41-1000,Supervisors of Sales Workers
36,New York,412,395404,290394,105010,5809,13013,6785,24505,19156,5349,228,641,239,41-2000,Retail Sales Workers
36,New York,413,111054,91108,19946,694,1653,380,5668,4673,995,30,91,17,41-3000,"Sales Representatives, Services"
36,New York,414,69524,56883,12641,394,1535,336,3820,3161,659,20,69,14,41-4000,"Sales Representatives, Wholesale and Manufacturing"
36,New York,419,72999,55003,17996,671,2736,975,4084,3171,913,30,125,31,41-9000,Other Sales and Related Workers
36,New York,431,74991,60308,14683,790,2261,357,4359,3571,788,30,125,12,43-1000,Supervisors of Office and Administrative Support Workers
36,New York,432,5108,4489,619,33,166,0,284,247,37,2,7,0,43-2000,Communications Equipment Operators
36,New York,433,143331,110830,32501,1580,5297,443,8446,6740,1706,72,274,17,43-3000,Financial Clerks
36,New York,434,287490,230832,56658,2372,8292,1563,17067,13976,3091,115,433,69,43-4000,Information and Record Clerks
36,New York,435,111097,83850,27247,1955,4038,1170,6493,5141,1352,70,188,40,43-5000,"Material Recording, Scheduling, Dispatching, and Distributing Workers"
36,New York,436,201467,168079,33388,1449,6684,881,12831,10915,1916,68,350,35,43-6000,Secretaries and Administrative Assistants
36,New York,439,190188,149872,40316,2228,6256,1231,12028,9794,2234,103,335,48,43-9000,Other Office and Administrative Support Workers
36,New York,451,1133,819,314,0,0,44,72,63,9,0,0,1,45-1000,"Supervisors of Farming, Fishing, and Forestry Workers"
36,New York,452,19280,13881,5399,1239,316,2271,1686,1356,330,76,13,143,45-2000,Agricultural Workers
36,New York,453,567,443,124,0,31,0,39,36,3,0,1,0,45-3000,Fishing and Hunting Workers
36,New York,454,2344,2128,216,71,23,0,223,217,6,2,1,0,45-4000,"Forest, Conservation, and Logging Workers"
36,New York,471,33017,23838,9179,386,1805,714,2065,1634,431,15,73,22,47-1000,Supervisors of Construction and Extraction Workers
36,New York,472,354281,204953,149328,25137,38952,20702,18744,13113,5631,735,1289,621,47-2000,Construction Trades Workers
36,New York,473,3049,1637,1412,335,246,297,164,108,56,10,13,10,47-3000,"Helpers, Construction Trades"
36,New York,474,23061,17624,5437,681,1180,201,1432,1190,242,21,59,7,47-4000,Other Construction and Related Workers
36,New York,475,2554,2077,477,108,112,0,175,156,19,1,5,0,47-5000,Extraction Workers
36,New York,491,11515,9318,2197,133,423,54,691,585,106,4,18,3,49-1000,"Supervisors of Installation, Maintenance, and Repair Workers"
36,New York,492,28880,22305,6575,262,1033,135,1536,1221,315,10,54,5,49-2000,"Electrical and Electronic Equipment Mechanics, Installers, and Repairers"
36,New York,493,80750,58288,22462,2447,4957,1598,4533,3601,932,80,205,56,49-3000,"Vehicle and Mobile Equipment Mechanics, Installers, and Repairers"
36,New York,499,95096,71915,23181,1853,4312,1267,5525,4520,1005,61,177,42,49-9000,"Other Installation, Maintenance, and Repair Occupations"
36,New York,511,29371,21916,7455,834,1306,371,1879,1515,364,36,60,15,51-1000,Supervisors of Production Workers
36,New York,512,30870,22712,8158,900,1761,593,2075,1667,408,35,68,24,51-2000,Assemblers and Fabricators
36,New York,513,32868,19316,13552,2010,1405,3118,1857,1318,539,61,54,96,51-3000,Food Processing Workers
36,New York,514,49751,38258,11493,1474,2833,867,3210,2705,505,58,109,24,51-4000,Metal Workers and Plastic Workers
36,New York,5151,9935,7743,2192,154,369,361,588,484,104,7,17,12,51-5100,Printing Workers
36,New York,516,28644,8951,19693,1434,3139,2383,1722,663,1059,51,151,95,51-6000,"Textile, Apparel, and Furnishings Workers"
36,New York,517,4954,3662,1292,111,474,127,321,256,65,5,19,4,51-7000,Woodworkers
36,New York,518,12741,10634,2107,194,447,49,770,666,104,3,20,1,51-8000,Plant and System Operators
36,New York,519,114279,78954,35325,4669,6595,2172,7122,5484,1638,156,286,80,51-9000,Other Production Occupations
36,New York,531,13689,10032,3657,189,463,85,781,603,178,6,24,6,53-1000,Supervisors of Transportation and Material Moving Workers
36,New York,532,10712,8135,2577,128,365,0,570,442,128,5,15,0,53-2000,Air Transportation Workers
36,New York,533,293531,155290,138241,8727,17538,6784,15042,9417,5625,291,687,208,53-3000,Motor Vehicle Operators
36,New York,534,11666,9187,2479,211,305,46,575,468,107,8,14,1,53-4000,Rail Transportation Workers
36,New York,535,2229,1888,341,0,18,28,161,135,26,0,3,1,53-5000,Water Transportation Workers
36,New York,536,23846,14663,9183,483,1687,197,1243,856,387,20,74,8,53-6000,Other Transportation Workers
36,New York,537,226972,164916,62056,8982,9560,8293,13956,11258,2698,299,427,262,53-7000,Material Moving Workers
37,North Carolina,111,60440,55321,5119,126,277,393,3364,3110,254,6,20,14,11-1000,Top Executives
37,North Carolina,112,31237,29121,2116,140,95,61,1801,1690,111,5,7,5,11-2000,"Advertising, Marketing, Promotions, Public Relations, and Sales Managers"
37,North Carolina,113,97021,88595,8426,532,473,932,5509,5077,432,24,29,41,11-3000,Operations Specialties Managers
37,North Carolina,119,271726,247893,23833,1698,1541,5941,14722,13594,1128,64,76,242,11-9000,Other Management Occupations
37,North Carolina,131,137881,126531,11350,423,885,1133,7816,7206,610,24,49,44,13-1000,Business Operations Specialists
37,North Carolina,132,93934,86826,7108,188,667,186,5228,4860,368,9,32,9,13-2000,Financial Specialists
37,North Carolina,1512,137155,107541,29614,238,815,869,7353,5953,1400,16,50,31,15-1200,Computer Occupations
37,North Carolina,152,7721,6162,1559,41,92,14,422,348,74,2,5,1,15-2000,Mathematical Science Occupations
37,North Carolina,171,4949,4461,488,0,0,0,303,269,34,0,1,0,17-1000,"Architects, Surveyors, and Cartographers"
37,North Carolina,172,48126,41254,6872,118,333,76,2686,2345,341,5,21,5,17-2000,Engineers
37,North Carolina,173,18828,17495,1333,45,198,124,1072,1006,66,2,11,4,17-3000,"Drafters, Engineering Technicians, and Mapping Technicians"
37,North Carolina,191,9477,7656,1821,26,126,0,534,436,98,2,4,0,19-1000,Life Scientists
37,North Carolina,192,13570,10237,3333,26,86,68,769,592,177,1,7,4,19-2000,Physical Scientists
37,North Carolina,193,5995,5586,409,0,27,21,360,341,19,0,2,1,19-3000,Social Scientists and Related Workers
37,North Carolina,194,12254,11199,1055,48,24,239,683,622,61,5,3,8,19-4000,"Life, Physical, and Social Science Technicians"
37,North Carolina,195,1784,1744,40,17,13,0,106,103,3,1,1,0,19-5000,Occupational Health and Safety Specialists and Technicians
37,North Carolina,211,62092,59692,2400,320,203,301,3443,3318,125,12,14,12,21-1000,"Counselors, Social Workers, and Other Community and Social Service Specialists"
37,North Carolina,212,20567,19056,1511,167,284,150,1256,1178,78,10,10,6,21-2000,Religious Workers
37,North Carolina,231,21979,21151,828,27,45,0,1262,1221,41,1,4,0,23-1000,"Lawyers, Judges, and Related Workers"
37,North Carolina,232,14397,13282,1115,289,121,118,856,803,53,9,7,7,23-2000,Legal Support Workers
37,North Carolina,251,44306,35476,8830,43,633,129,2662,2186,476,2,32,8,25-1000,Postsecondary Teachers
37,North Carolina,252,165467,157568,7899,408,1768,299,9989,9557,432,16,85,24,25-2000,"Preschool, Elementary, Middle, Secondary, and Special Education Teachers"
37,North Carolina,253,25307,23705,1602,21,78,194,1632,1526,106,3,5,7,25-3000,Other Teachers and Instructors
37,North Carolina,254,7235,6906,329,39,48,0,486,464,22,2,3,0,25-4000,"Librarians, Curators, and Archivists"
37,North Carolina,259,34241,31903,2338,307,267,306,2233,2095,138,11,17,16,25-9000,Other Educational Instruction and Library Occupations
37,North Carolina,271,26443,24396,2047,53,336,331,1606,1504,102,3,14,14,27-1000,Art and Design Workers
37,North Carolina,272,19815,18673,1142,37,180,51,1373,1285,88,5,7,4,27-2000,"Entertainers and Performers, Sports and Related Workers"
37,North Carolina,273,20224,18194,2030,109,380,485,1272,1141,131,8,20,23,27-3000,Media and Communication Workers
37,North Carolina,274,8359,7896,463,12,134,12,501,479,22,2,4,1,27-4000,Media and Communication Equipment Workers
37,North Carolina,291,190184,174618,15566,309,739,462,10608,9836,772,11,34,21,29-1000,Healthcare Diagnosing or Treating Practitioners
37,North Carolina,292,89673,84650,5023,422,216,479,4730,4499,231,18,15,13,29-2000,Health Technologists and Technicians
37,North Carolina,299,2913,2738,175,0,0,65,169,160,9,0,0,3,29-9000,Other Healthcare Practitioners and Technical Occupations
37,North Carolina,3111,92514,86099,6415,411,377,668,4854,4565,289,19,20,37,31-1100,"Home Health and Personal Care Aides; and Nursing Assistants, Orderlies, and Psychiatric Aides"
37,North Carolina,312,3057,2971,86,0,32,0,196,190,6,1,2,0,31-2000,Occupational Therapy and Physical Therapist Assistants and Aides
37,North Carolina,319,41045,38676,2369,246,324,482,2254,2120,134,12,12,24,31-9000,Other Healthcare Support Occupations
37,North Carolina,331,9316,8942,374,0,0,17,564,554,10,0,0,1,33-1000,Supervisors of Protective Service Workers
37,North Carolina,332,10678,10598,80,12,0,0,565,560,5,1,0,0,33-2000,Firefighting and Prevention Workers
37,North Carolina,333,38857,38057,800,8,145,258,2038,2000,38,1,7,6,33-3000,Law Enforcement Workers
37,North Carolina,339,27456,26233,1223,144,353,49,1789,1729,60,6,7,4,33-9000,Other Protective Service Workers
37,North Carolina,351,33251,28928,4323,405,313,887,1502,1323,179,18,13,37,35-1000,Supervisors of Food Preparation and Serving Workers
37,North Carolina,352,104825,86565,18260,2641,877,10524,5607,4860,747,100,45,373,35-2000,Cooks and Food Preparation Workers
37,North Carolina,353,106957,97162,9795,1041,553,4356,5760,5300,460,41,37,164,35-3000,Food and Beverage Serving Workers
37,North Carolina,359,29104,25381,3723,421,326,1437,1885,1704,181,20,16,64,35-9000,Other Food Preparation and Serving Related Workers
37,North Carolina,371,14577,12517,2060,366,233,997,714,639,75,10,13,28,37-1000,Supervisors of Building and Grounds Cleaning and Maintenance Workers
37,North Carolina,372,110186,86377,23809,5310,2164,11101,5916,4907,1009,216,95,440,37-2000,Building Cleaning and Pest Control Workers
37,North Carolina,373,41438,30311,11127,1901,70,8485,2333,1939,394,63,7,292,37-3000,Grounds Maintenance Workers
37,North Carolina,391,2817,2511,306,23,0,17,132,123,9,1,0,1,39-1000,Supervisors of Personal Care and Service Workers
37,North Carolina,392,10094,9521,573,24,39,239,594,560,34,1,2,11,39-2000,Animal Care and Service Workers
37,North Carolina,393,6852,6605,247,60,0,11,508,493,15,3,0,1,39-3000,Entertainment Attendants and Related Workers
37,North Carolina,394,1827,1804,23,0,0,0,103,102,1,0,0,0,39-4000,Funeral Service Workers
37,North Carolina,395,42020,32762,9258,232,203,681,1987,1573,414,17,8,32,39-5000,Personal Appearance Workers
37,North Carolina,396,1199,984,215,16,0,0,58,48,10,1,0,0,39-6000,"Baggage Porters, Bellhops, and Concierges"
37,North Carolina,397,1732,1623,109,0,51,0,143,131,12,0,4,0,39-7000,Tour and Travel Guides
37,North Carolina,399,51646,47519,4127,567,637,651,3452,3232,220,20,33,34,39-9000,Other Personal Care and Service Workers
37,North Carolina,411,132844,123511,9333,309,841,1642,6964,6507,457,18,48,63,41-1000,Supervisors of Sales Workers
37,North Carolina,412,214608,198779,15829,1750,1282,2900,12858,12010,848,83,70,131,41-2000,Retail Sales Workers
37,North Carolina,413,48171,45805,2366,164,196,457,2582,2461,121,7,10,11,41-3000,"Sales Representatives, Services"
37,North Carolina,414,40333,37771,2562,381,229,622,2275,2157,118,14,9,23,41-4000,"Sales Representatives, Wholesale and Manufacturing"
37,North Carolina,419,39500,36993,2507,137,482,554,2321,2180,141,6,17,22,41-9000,Other Sales and Related Workers
37,North Carolina,431,35396,33334,2062,218,141,246,2032,1925,107,11,10,14,43-1000,Supervisors of Office and Administrative Support Workers
37,North Carolina,432,2463,2202,261,10,0,119,139,130,9,1,0,1,43-2000,Communications Equipment Operators
37,North Carolina,433,59703,56645,3058,358,247,591,3542,3367,175,15,15,22,43-3000,Financial Clerks
37,North Carolina,434,149277,141370,7907,485,717,1546,8535,8121,414,22,40,66,43-4000,Information and Record Clerks
37,North Carolina,435,61895,57526,4369,456,220,1450,3274,3082,192,19,10,45,43-5000,"Material Recording, Scheduling, Dispatching, and Distributing Workers"
37,North Carolina,436,73445,69497,3948,365,215,979,4847,4591,256,24,25,44,43-6000,Secretaries and Administrative Assistants
37,North Carolina,439,75090,71172,3918,267,516,603,4531,4277,254,21,29,36,43-9000,Other Office and Administrative Support Workers
37,North Carolina,451,2052,1837,215,60,0,155,109,95,14,2,0,12,45-1000,"Supervisors of Farming, Fishing, and Forestry Workers"
37,North Carolina,452,20105,9200,10905,1977,9,8807,1349,682,667,74,1,578,45-2000,Agricultural Workers
37,North Carolina,453,1126,1103,23,0,0,23,100,97,3,0,1,1,45-3000,Fishing and Hunting Workers
37,North Carolina,454,3250,3015,235,0,46,173,172,164,8,0,1,6,45-4000,"Forest, Conservation, and Logging Workers"
37,North Carolina,471,23152,20234,2918,661,40,1840,1222,1107,115,25,1,69,47-1000,Supervisors of Construction and Extraction Workers
37,North Carolina,472,200052,134724,65328,15556,2529,43134,9427,7330,2097,489,88,1316,47-2000,Construction Trades Workers
37,North Carolina,473,2102,1857,245,74,23,117,123,110,13,3,2,6,47-3000,"Helpers, Construction Trades"
37,North Carolina,474,10623,8790,1833,310,133,1032,508,454,54,10,4,27,47-4000,Other Construction and Related Workers
37,North Carolina,475,1989,1721,268,69,0,194,120,110,10,5,0,4,47-5000,Extraction Workers
37,North Carolina,491,8612,8219,393,23,35,32,464,443,21,1,4,2,49-1000,"Supervisors of Installation, Maintenance, and Repair Workers"
37,North Carolina,492,16943,15858,1085,157,147,249,840,791,49,6,5,7,49-2000,"Electrical and Electronic Equipment Mechanics, Installers, and Repairers"
37,North Carolina,493,59450,53984,5466,1166,287,2492,3031,2831,200,40,14,75,49-3000,"Vehicle and Mobile Equipment Mechanics, Installers, and Repairers"
37,North Carolina,499,75184,67252,7932,1471,502,3466,3872,3596,276,48,19,107,49-9000,"Other Installation, Maintenance, and Repair Occupations"
37,North Carolina,511,32316,29600,2716,272,160,1280,1712,1587,125,12,9,50,51-1000,Supervisors of Production Workers
37,North Carolina,512,41667,34572,7095,1249,250,3416,2136,1847,289,40,11,120,51-2000,Assemblers and Fabricators
37,North Carolina,513,26541,20109,6432,1204,136,2910,1341,1055,286,52,11,117,51-3000,Food Processing Workers
37,North Carolina,514,51511,45206,6305,965,162,3065,2563,2301,262,28,10,121,51-4000,Metal Workers and Plastic Workers
37,North Carolina,5151,5281,4934,347,120,53,45,289,271,18,5,2,3,51-5100,Printing Workers
37,North Carolina,516,33374,23830,9544,2121,255,4221,1732,1327,405,76,15,169,51-6000,"Textile, Apparel, and Furnishings Workers"
37,North Carolina,517,6794,5383,1411,266,143,841,362,316,46,8,5,26,51-7000,Woodworkers
37,North Carolina,518,7346,7073,273,119,0,20,405,393,12,4,0,1,51-8000,Plant and System Operators
37,North Carolina,519,121236,103825,17411,2911,592,6739,6481,5689,792,113,28,291,51-9000,Other Production Occupations
37,North Carolina,531,7021,6664,357,92,0,18,333,314,19,3,0,1,53-1000,Supervisors of Transportation and Material Moving Workers
37,North Carolina,532,8747,8253,494,0,92,0,462,432,30,0,4,1,53-2000,Air Transportation Workers
37,North Carolina,533,131583,120329,11254,2085,732,2096,6659,6220,439,64,40,76,53-3000,Motor Vehicle Operators
37,North Carolina,534,1522,1472,50,0,0,0,84,81,3,0,0,0,53-4000,Rail Transportation Workers
37,North Carolina,535,1263,1198,65,0,0,0,91,89,2,0,0,0,53-5000,Water Transportation Workers
37,North Carolina,536,6722,5971,751,58,28,233,354,320,34,4,3,9,53-6000,Other Transportation Workers
37,North Carolina,537,171900,150995,20905,3426,789,8463,9386,8489,897,152,44,338,53-7000,Material Moving Workers
38,North Dakota,111,5668,5651,17,0,0,0,280,277,3,0,0,0,11-1000,Top Executives
38,North Dakota,112,1834,1778,56,0,0,56,67,65,2,0,0,1,11-2000,"Advertising, Marketing, Promotions, Public Relations, and Sales Managers"
38,North Dakota,113,6099,5414,685,0,0,0,285,275,10,0,0,0,11-3000,Operations Specialties Managers
38,North Dakota,119,30093,29298,795,0,0,28,2109,2075,34,0,0,3,11-9000,Other Management Occupations
38,North Dakota,131,8437,8245,192,0,0,0,385,376,9,0,0,0,13-1000,Business Operations Specialists
38,North Dakota,132,9114,8788,326,0,0,0,426,417,9,0,0,0,13-2000,Financial Specialists
38,North Dakota,1512,6094,5754,340,0,0,29,276,265,11,0,0,2,15-1200,Computer Occupations
38,North Dakota,152,243,57,186,0,0,0,6,4,2,0,0,0,15-2000,Mathematical Science Occupations
38,North Dakota,171,409,409,0,0,0,0,15,15,0,0,0,0,17-1000,"Architects, Surveyors, and Cartographers"
38,North Dakota,172,4398,3872,526,0,0,0,161,156,5,0,0,0,17-2000,Engineers
38,North Dakota,173,1789,1777,12,0,0,0,110,108,2,0,0,0,17-3000,"Drafters, Engineering Technicians, and Mapping Technicians"
38,North Dakota,191,990,873,117,3,0,0,55,49,6,1,0,0,19-1000,Life Scientists
38,North Dakota,192,761,686,75,0,0,0,33,29,4,0,0,0,19-2000,Physical Scientists
38,North Dakota,193,586,586,0,0,0,0,18,18,0,0,0,0,19-3000,Social Scientists and Related Workers
38,North Dakota,194,899,886,13,0,0,0,70,68,2,0,0,0,19-4000,"Life, Physical, and Social Science Technicians"
38,North Dakota,195,181,177,4,0,0,0,9,8,1,0,0,0,19-5000,Occupational Health and Safety Specialists and Technicians
38,North Dakota,211,3992,3892,100,14,0,0,217,209,8,1,0,0,21-1000,"Counselors, Social Workers, and Other Community and Social Service Specialists"
38,North Dakota,212,1485,1348,137,0,20,0,104,97,7,0,1,1,21-2000,Religious Workers
38,North Dakota,231,1290,1265,25,0,0,0,66,65,1,0,0,0,23-1000,"Lawyers, Judges, and Related Workers"
38,North Dakota,232,1168,1135,33,0,0,0,41,39,2,0,0,0,23-2000,Legal Support Workers
38,North Dakota,251,3069,2614,455,0,16,0,166,141,25,0,2,0,25-1000,Postsecondary Teachers
38,North Dakota,252,12879,12427,452,93,6,0,823,799,24,3,1,0,25-2000,"Preschool, Elementary, Middle, Secondary, and Special Education Teachers"
38,North Dakota,253,1320,1228,92,0,0,0,70,62,8,0,0,0,25-3000,Other Teachers and Instructors
38,North Dakota,254,445,437,8,8,0,0,32,31,1,1,0,0,25-4000,"Librarians, Curators, and Archivists"
38,North Dakota,259,4076,3819,257,0,0,0,233,228,5,0,0,0,25-9000,Other Educational Instruction and Library Occupations
38,North Dakota,271,1867,1804,63,0,0,0,84,81,3,0,0,0,27-1000,Art and Design Workers
38,North Dakota,272,1054,1054,0,0,0,0,76,76,0,0,0,0,27-2000,"Entertainers and Performers, Sports and Related Workers"
38,North Dakota,273,1440,1157,283,0,0,0,59,54,5,0,0,0,27-3000,Media and Communication Workers
38,North Dakota,274,645,645,0,0,0,0,26,25,1,0,0,0,27-4000,Media and Communication Equipment Workers
38,North Dakota,291,18128,17158,970,0,4,2,855,812,43,0,1,1,29-1000,Healthcare Diagnosing or Treating Practitioners
38,North Dakota,292,8476,8210,266,0,0,0,392,385,7,0,0,0,29-2000,Health Technologists and Technicians
38,North Dakota,299,209,209,0,0,0,0,11,11,0,0,0,0,29-9000,Other Healthcare Practitioners and Technical Occupations
38,North Dakota,3111,10413,9345,1068,0,48,0,546,513,33,0,1,0,31-1100,"Home Health and Personal Care Aides; and Nursing Assistants, Orderlies, and Psychiatric Aides"
38,North Dakota,312,155,155,0,0,0,0,16,16,0,0,0,0,31-2000,Occupational Therapy and Physical Therapist Assistants and Aides
38,North Dakota,319,2537,2518,19,0,0,0,139,136,3,0,0,0,31-9000,Other Healthcare Support Occupations
38,North Dakota,331,575,575,0,0,0,0,31,31,0,0,0,0,33-1000,Supervisors of Protective Service Workers
38,North Dakota,332,776,744,32,0,0,32,33,32,1,0,0,1,33-2000,Firefighting and Prevention Workers
38,North Dakota,333,2447,2424,23,0,0,0,150,148,2,0,0,0,33-3000,Law Enforcement Workers
38,North Dakota,339,2260,2185,75,0,0,0,132,129,3,0,0,0,33-9000,Other Protective Service Workers
38,North Dakota,351,1996,1948,48,0,0,0,90,87,3,0,0,0,35-1000,Supervisors of Food Preparation and Serving Workers
38,North Dakota,352,8218,7449,769,0,228,113,465,445,20,0,1,3,35-2000,Cooks and Food Preparation Workers
38,North Dakota,353,8874,8232,642,0,0,199,438,423,15,0,1,2,35-3000,Food and Beverage Serving Workers
38,North Dakota,359,2746,2527,219,0,0,0,134,126,8,0,0,0,35-9000,Other Food Preparation and Serving Related Workers
38,North Dakota,371,879,706,173,0,0,173,39,38,1,0,0,1,37-1000,Supervisors of Building and Grounds Cleaning and Maintenance Workers
38,North Dakota,372,9170,7792,1378,0,291,122,588,545,43,0,5,4,37-2000,Building Cleaning and Pest Control Workers
38,North Dakota,373,2054,2049,5,0,0,0,214,212,2,0,0,0,37-3000,Grounds Maintenance Workers
38,North Dakota,391,342,342,0,0,0,0,17,17,0,0,0,0,39-1000,Supervisors of Personal Care and Service Workers
38,North Dakota,392,259,259,0,0,0,0,33,33,0,0,0,0,39-2000,Animal Care and Service Workers
38,North Dakota,393,1036,1036,0,0,0,0,65,65,0,0,0,0,39-3000,Entertainment Attendants and Related Workers
38,North Dakota,394,84,84,0,0,0,0,4,4,0,0,0,0,39-4000,Funeral Service Workers
38,North Dakota,395,2646,2437,209,0,0,0,131,124,7,0,0,0,39-5000,Personal Appearance Workers
38,North Dakota,396,32,32,0,0,0,0,6,6,0,0,0,0,39-6000,"Baggage Porters, Bellhops, and Concierges"
38,North Dakota,397,214,214,0,0,0,0,12,11,1,0,0,0,39-7000,Tour and Travel Guides
38,North Dakota,399,6548,6227,321,21,20,7,456,439,17,1,3,1,39-9000,Other Personal Care and Service Workers
38,North Dakota,411,10567,10394,173,0,0,50,569,564,5,0,0,1,41-1000,Supervisors of Sales Workers
38,North Dakota,412,15314,14846,468,0,95,59,923,891,32,1,1,3,41-2000,Retail Sales Workers
38,North Dakota,413,3500,3386,114,0,0,0,169,165,4,0,0,0,41-3000,"Sales Representatives, Services"
38,North Dakota,414,2823,2793,30,0,0,0,151,148,3,0,0,0,41-4000,"Sales Representatives, Wholesale and Manufacturing"
38,North Dakota,419,1860,1750,110,0,0,0,106,104,2,0,0,0,41-9000,Other Sales and Related Workers
38,North Dakota,431,3075,2899,176,0,0,0,152,147,5,0,0,0,43-1000,Supervisors of Office and Administrative Support Workers
38,North Dakota,432,231,231,0,0,0,0,10,10,0,0,0,0,43-2000,Communications Equipment Operators
38,North Dakota,433,6362,6299,63,0,0,0,383,379,4,0,0,0,43-3000,Financial Clerks
38,North Dakota,434,13025,12690,335,0,0,0,634,626,8,1,0,1,43-4000,Information and Record Clerks
38,North Dakota,435,5047,4628,419,0,0,0,269,265,4,0,0,0,43-5000,"Material Recording, Scheduling, Dispatching, and Distributing Workers"
38,North Dakota,436,8870,8651,219,0,0,46,552,541,11,0,0,1,43-6000,Secretaries and Administrative Assistants
38,North Dakota,439,6477,6375,102,10,0,0,335,329,6,1,0,1,43-9000,Other Office and Administrative Support Workers
38,North Dakota,451,128,128,0,0,0,0,12,12,0,0,0,0,45-1000,"Supervisors of Farming, Fishing, and Forestry Workers"
38,North Dakota,452,5681,5353,328,27,0,158,539,525,14,1,0,8,45-2000,Agricultural Workers
38,North Dakota,453,6,6,0,0,0,0,2,2,0,0,0,0,45-3000,Fishing and Hunting Workers
38,North Dakota,454,159,159,0,0,0,0,10,10,0,0,0,0,45-4000,"Forest, Conservation, and Logging Workers"
38,North Dakota,471,3556,3512,44,0,0,44,174,173,1,0,0,1,47-1000,Supervisors of Construction and Extraction Workers
38,North Dakota,472,18548,17812,736,42,102,171,996,976,20,1,1,6,47-2000,Construction Trades Workers
38,North Dakota,473,21,21,0,0,0,0,1,1,0,0,0,0,47-3000,"Helpers, Construction Trades"
38,North Dakota,474,1324,1199,125,0,0,0,85,84,1,0,0,0,47-4000,Other Construction and Related Workers
38,North Dakota,475,3083,2670,413,0,212,50,129,122,7,0,1,2,47-5000,Extraction Workers
38,North Dakota,491,662,662,0,0,0,0,45,45,0,0,0,0,49-1000,"Supervisors of Installation, Maintenance, and Repair Workers"
38,North Dakota,492,877,810,67,0,0,0,59,58,1,0,0,0,49-2000,"Electrical and Electronic Equipment Mechanics, Installers, and Repairers"
38,North Dakota,493,7497,7363,134,17,0,0,405,400,5,1,0,0,49-3000,"Vehicle and Mobile Equipment Mechanics, Installers, and Repairers"
38,North Dakota,499,6114,5774,340,0,10,0,355,349,6,0,1,0,49-9000,"Other Installation, Maintenance, and Repair Occupations"
38,North Dakota,511,1815,1778,37,0,0,2,105,102,3,0,0,1,51-1000,Supervisors of Production Workers
38,North Dakota,512,3798,2938,860,0,0,0,194,179,15,0,0,0,51-2000,Assemblers and Fabricators
38,North Dakota,513,1063,1043,20,0,0,0,66,64,2,0,0,0,51-3000,Food Processing Workers
38,North Dakota,514,5159,4461,698,41,0,451,302,293,9,1,0,2,51-4000,Metal Workers and Plastic Workers
38,North Dakota,5151,444,444,0,0,0,0,24,24,0,0,0,0,51-5100,Printing Workers
38,North Dakota,516,584,530,54,0,0,0,42,41,1,0,0,0,51-6000,"Textile, Apparel, and Furnishings Workers"
38,North Dakota,517,276,276,0,0,0,0,11,11,0,0,0,0,51-7000,Woodworkers
38,North Dakota,518,1231,1201,30,0,0,0,68,66,2,0,0,0,51-8000,Plant and System Operators
38,North Dakota,519,6277,5746,531,0,0,23,337,319,18,0,0,2,51-9000,Other Production Occupations
38,North Dakota,531,483,483,0,0,0,0,32,32,0,0,0,0,53-1000,Supervisors of Transportation and Material Moving Workers
38,North Dakota,532,1016,908,108,0,0,0,44,41,3,0,0,0,53-2000,Air Transportation Workers
38,North Dakota,533,12569,11746,823,8,0,31,729,704,25,1,0,3,53-3000,Motor Vehicle Operators
38,North Dakota,534,1410,1383,27,0,0,0,77,75,2,0,0,0,53-4000,Rail Transportation Workers
38,North Dakota,535,31,5,26,0,0,0,2,1,1,0,0,0,53-5000,Water Transportation Workers
38,North Dakota,536,767,767,0,0,0,0,55,54,1,0,0,0,53-6000,Other Transportation Workers
38,North Dakota,537,14080,13260,820,0,0,132,753,731,22,0,0,2,53-7000,Material Moving Workers
39,Ohio,111,74882,70971,3911,69,101,325,3985,3809,176,3,5,5,11-1000,Top Executives
39,Ohio,112,35549,34184,1365,15,59,131,1873,1802,71,1,3,4,11-2000,"Advertising, Marketing, Promotions, Public Relations, and Sales Managers"
39,Ohio,113,111148,104944,6204,118,270,254,5970,5680,290,5,15,10,11-3000,Operations Specialties Managers
39,Ohio,119,288829,274810,14019,324,761,1321,15470,14819,651,15,33,49,11-9000,Other Management Occupations
39,Ohio,131,159085,151405,7680,68,429,214,8571,8196,375,5,19,8,13-1000,Business Operations Specialists
39,Ohio,132,110929,104770,6159,16,165,186,6043,5740,303,2,13,8,13-2000,Financial Specialists
39,Ohio,1512,137965,116657,21308,93,391,214,7252,6380,872,5,20,13,15-1200,Computer Occupations
39,Ohio,152,7890,6880,1010,0,0,17,406,358,48,0,0,1,15-2000,Mathematical Science Occupations
39,Ohio,171,5376,4735,641,81,36,0,311,279,32,2,1,0,17-1000,"Architects, Surveyors, and Cartographers"
39,Ohio,172,75668,67303,8365,105,362,376,4108,3734,374,4,18,17,17-2000,Engineers
39,Ohio,173,22500,21551,949,0,18,9,1389,1327,62,0,1,8,17-3000,"Drafters, Engineering Technicians, and Mapping Technicians"
39,Ohio,191,6668,4611,2057,13,118,106,405,286,119,1,5,4,19-1000,Life Scientists
39,Ohio,192,12797,10027,2770,22,235,0,705,559,146,2,10,0,19-2000,Physical Scientists
39,Ohio,193,6337,6148,189,0,21,14,374,366,8,0,1,1,19-3000,Social Scientists and Related Workers
39,Ohio,194,14685,13634,1051,26,84,24,897,841,56,1,3,1,19-4000,"Life, Physical, and Social Science Technicians"
39,Ohio,195,2676,2587,89,0,0,0,154,149,5,0,0,0,19-5000,Occupational Health and Safety Specialists and Technicians
39,Ohio,211,70328,68258,2070,134,220,59,3907,3822,85,5,7,5,21-1000,"Counselors, Social Workers, and Other Community and Social Service Specialists"
39,Ohio,212,17493,16550,943,7,48,0,1112,1056,56,1,1,1,21-2000,Religious Workers
39,Ohio,231,28008,27185,823,0,16,0,1573,1528,45,0,1,0,23-1000,"Lawyers, Judges, and Related Workers"
39,Ohio,232,14993,14647,346,0,24,0,813,796,17,0,1,0,23-2000,Legal Support Workers
39,Ohio,251,43713,33831,9882,111,219,202,2684,2141,543,4,21,10,25-1000,Postsecondary Teachers
39,Ohio,252,173640,169591,4049,111,270,122,10396,10152,244,7,17,9,25-2000,"Preschool, Elementary, Middle, Secondary, and Special Education Teachers"
39,Ohio,253,24935,23939,996,9,11,133,1628,1543,85,1,5,4,25-3000,Other Teachers and Instructors
39,Ohio,254,10503,10161,342,0,0,29,675,656,19,0,0,1,25-4000,"Librarians, Curators, and Archivists"
39,Ohio,259,36227,34137,2090,51,92,145,2432,2306,126,3,4,7,25-9000,Other Educational Instruction and Library Occupations
39,Ohio,271,31541,29979,1562,63,86,18,1830,1754,76,2,5,3,27-1000,Art and Design Workers
39,Ohio,272,19353,18595,758,32,47,0,1293,1228,65,3,3,0,27-2000,"Entertainers and Performers, Sports and Related Workers"
39,Ohio,273,21483,19886,1597,23,179,188,1315,1225,90,1,8,7,27-3000,Media and Communication Workers
39,Ohio,274,8059,7678,381,0,17,0,532,508,24,2,2,1,27-4000,Media and Communication Equipment Workers
39,Ohio,291,251825,234376,17449,260,561,336,13483,12649,834,8,30,12,29-1000,Healthcare Diagnosing or Treating Practitioners
39,Ohio,292,117630,112548,5082,26,173,228,6400,6186,214,1,7,9,29-2000,Health Technologists and Technicians
39,Ohio,299,3622,3380,242,0,0,0,179,167,12,0,1,0,29-9000,Other Healthcare Practitioners and Technical Occupations
39,Ohio,3111,124635,116461,8174,183,125,85,6787,6435,352,7,12,9,31-1100,"Home Health and Personal Care Aides; and Nursing Assistants, Orderlies, and Psychiatric Aides"
39,Ohio,312,8005,7750,255,0,0,27,430,422,8,0,0,2,31-2000,Occupational Therapy and Physical Therapist Assistants and Aides
39,Ohio,319,50179,48708,1471,80,134,162,2793,2706,87,5,6,12,31-9000,Other Healthcare Support Occupations
39,Ohio,331,8700,8513,187,0,0,0,509,501,8,0,0,0,33-1000,Supervisors of Protective Service Workers
39,Ohio,332,14195,14076,119,11,0,0,753,748,5,1,0,0,33-2000,Firefighting and Prevention Workers
39,Ohio,333,41524,40930,594,12,22,58,2148,2124,24,1,1,2,33-3000,Law Enforcement Workers
39,Ohio,339,34723,33539,1184,3,73,46,2371,2301,70,1,4,3,33-9000,Other Protective Service Workers
39,Ohio,351,35512,32858,2654,37,238,330,1846,1730,116,3,7,11,35-1000,Supervisors of Food Preparation and Serving Workers
39,Ohio,352,130044,121077,8967,692,256,3317,8066,7694,372,23,10,86,35-2000,Cooks and Food Preparation Workers
39,Ohio,353,126883,121531,5352,148,145,1221,7895,7645,250,12,6,34,35-3000,Food and Beverage Serving Workers
39,Ohio,359,37292,35331,1961,126,104,611,2585,2476,109,6,3,20,35-9000,Other Food Preparation and Serving Related Workers
39,Ohio,371,15370,14544,826,42,42,383,760,735,25,2,2,8,37-1000,Supervisors of Building and Grounds Cleaning and Maintenance Workers
39,Ohio,372,129327,119309,10018,1045,691,1535,8343,7935,408,49,24,54,37-2000,Building Cleaning and Pest Control Workers
39,Ohio,373,37024,34050,2974,510,228,1890,2800,2694,106,16,6,54,37-3000,Grounds Maintenance Workers
39,Ohio,391,2883,2486,397,0,0,12,166,154,12,0,0,1,39-1000,Supervisors of Personal Care and Service Workers
39,Ohio,392,9671,9495,176,0,69,66,627,616,11,0,1,4,39-2000,Animal Care and Service Workers
39,Ohio,393,7812,7612,200,0,55,0,743,720,23,0,4,0,39-3000,Entertainment Attendants and Related Workers
39,Ohio,394,1474,1474,0,0,0,0,104,103,1,0,0,0,39-4000,Funeral Service Workers
39,Ohio,395,40617,36315,4302,107,76,44,2048,1880,168,4,4,1,39-5000,Personal Appearance Workers
39,Ohio,396,1074,1007,67,0,0,0,55,52,3,0,0,1,39-6000,"Baggage Porters, Bellhops, and Concierges"
39,Ohio,397,2037,1993,44,0,0,7,174,169,5,0,0,2,39-7000,Tour and Travel Guides
39,Ohio,399,58055,55252,2803,164,137,63,4267,4088,179,11,11,9,39-9000,Other Personal Care and Service Workers
39,Ohio,411,143479,137012,6467,132,209,174,7703,7387,316,7,12,11,41-1000,Supervisors of Sales Workers
39,Ohio,412,215375,206295,9080,130,340,256,14162,13679,483,10,18,24,41-2000,Retail Sales Workers
39,Ohio,413,51730,50338,1392,34,135,40,2676,2610,66,3,5,2,41-3000,"Sales Representatives, Services"
39,Ohio,414,52803,51235,1568,24,160,33,2856,2776,80,2,8,1,41-4000,"Sales Representatives, Wholesale and Manufacturing"
39,Ohio,419,36509,35397,1112,12,0,96,2167,2103,64,1,1,6,41-9000,Other Sales and Related Workers
39,Ohio,431,42733,41027,1706,0,77,153,2378,2307,71,0,3,4,43-1000,Supervisors of Office and Administrative Support Workers
39,Ohio,432,2560,2535,25,0,0,0,158,157,1,0,0,0,43-2000,Communications Equipment Operators
39,Ohio,433,84640,81463,3177,203,286,207,5058,4905,153,6,11,5,43-3000,Financial Clerks
39,Ohio,434,189612,183099,6513,230,645,579,11016,10671,345,14,29,21,43-4000,Information and Record Clerks
39,Ohio,435,85686,82197,3489,139,155,193,4892,4751,141,6,5,12,43-5000,"Material Recording, Scheduling, Dispatching, and Distributing Workers"
39,Ohio,436,103653,101670,1983,24,70,135,6672,6542,130,3,5,8,43-6000,Secretaries and Administrative Assistants
39,Ohio,439,98910,95614,3296,131,39,150,6035,5861,174,3,4,10,43-9000,Other Office and Administrative Support Workers
39,Ohio,451,1035,861,174,32,0,106,60,52,8,1,0,6,45-1000,"Supervisors of Farming, Fishing, and Forestry Workers"
39,Ohio,452,14893,12945,1948,351,21,1408,1113,1008,105,10,1,80,45-2000,Agricultural Workers
39,Ohio,453,94,94,0,0,0,0,7,7,0,0,0,0,45-3000,Fishing and Hunting Workers
39,Ohio,454,1299,1229,70,0,61,0,104,102,2,0,1,0,45-4000,"Forest, Conservation, and Logging Workers"
39,Ohio,471,21133,20756,377,0,28,221,1205,1186,19,0,1,7,47-1000,Supervisors of Construction and Extraction Workers
39,Ohio,472,181947,171757,10190,2377,292,4549,11089,10703,386,71,18,135,47-2000,Construction Trades Workers
39,Ohio,473,448,448,0,0,0,0,43,41,2,0,0,1,47-3000,"Helpers, Construction Trades"
39,Ohio,474,12162,11898,264,38,0,143,739,728,11,2,1,4,47-4000,Other Construction and Related Workers
39,Ohio,475,5521,5501,20,0,0,11,379,377,2,0,0,1,47-5000,Extraction Workers
39,Ohio,491,9785,9597,188,0,47,0,554,547,7,0,1,0,49-1000,"Supervisors of Installation, Maintenance, and Repair Workers"
39,Ohio,492,14559,13767,792,47,13,0,777,750,27,1,1,1,49-2000,"Electrical and Electronic Equipment Mechanics, Installers, and Repairers"
39,Ohio,493,58838,57029,1809,233,21,209,3318,3242,76,6,2,8,49-3000,"Vehicle and Mobile Equipment Mechanics, Installers, and Repairers"
39,Ohio,499,79824,77261,2563,179,134,256,4597,4484,113,8,5,8,49-9000,"Other Installation, Maintenance, and Repair Occupations"
39,Ohio,511,47521,45678,1843,15,92,271,2719,2645,74,1,4,12,51-1000,Supervisors of Production Workers
39,Ohio,512,74261,69226,5035,654,67,693,4504,4314,190,14,5,32,51-2000,Assemblers and Fabricators
39,Ohio,513,22592,20854,1738,76,267,196,1319,1241,78,4,6,10,51-3000,Food Processing Workers
39,Ohio,514,109943,104912,5031,154,281,786,6500,6283,217,9,13,18,51-4000,Metal Workers and Plastic Workers
39,Ohio,5151,9607,9378,229,0,21,0,592,577,15,0,1,0,51-5100,Printing Workers
39,Ohio,516,14684,12201,2483,45,116,228,932,817,115,5,5,9,51-6000,"Textile, Apparel, and Furnishings Workers"
39,Ohio,517,6789,6507,282,0,0,148,371,363,8,0,0,4,51-7000,Woodworkers
39,Ohio,518,8618,8479,139,0,0,0,529,523,6,0,0,0,51-8000,Plant and System Operators
39,Ohio,519,159989,149471,10518,738,571,1002,9704,9260,444,22,20,46,51-9000,Other Production Occupations
39,Ohio,531,8695,8294,401,69,0,80,463,447,16,3,0,1,53-1000,Supervisors of Transportation and Material Moving Workers
39,Ohio,532,5957,5695,262,9,9,0,328,315,13,1,1,0,53-2000,Air Transportation Workers
39,Ohio,533,163435,154177,9258,273,148,446,9118,8806,312,9,6,14,53-3000,Motor Vehicle Operators
39,Ohio,534,4659,4635,24,0,0,0,256,254,2,0,0,0,53-4000,Rail Transportation Workers
39,Ohio,535,768,768,0,0,0,0,59,59,0,0,0,0,53-5000,Water Transportation Workers
39,Ohio,536,8928,8437,491,0,0,38,505,484,21,0,0,3,53-6000,Other Transportation Workers
39,Ohio,537,255183,240451,14732,871,320,2387,16038,15458,580,27,18,89,53-7000,Material Moving Workers
40,Oklahoma,111,22225,21401,824,114,23,114,1038,999,39,5,1,4,11-1000,Top Executives
40,Oklahoma,112,8990,8650,340,13,7,24,374,363,11,1,1,1,11-2000,"Advertising, Marketing, Promotions, Public Relations, and Sales Managers"
40,Oklahoma,113,29631,28349,1282,15,118,313,1366,1320,46,1,6,8,11-3000,Operations Specialties Managers
40,Oklahoma,119,97856,92283,5573,140,133,1694,5081,4863,218,5,6,73,11-9000,Other Management Occupations
40,Oklahoma,131,40680,39197,1483,173,107,237,1875,1815,60,6,3,8,13-1000,Business Operations Specialists
40,Oklahoma,132,35459,33601,1858,38,191,93,1622,1559,63,2,11,4,13-2000,Financial Specialists
40,Oklahoma,1512,31196,27996,3200,42,75,361,1379,1286,93,1,1,10,15-1200,Computer Occupations
40,Oklahoma,152,2232,2095,137,24,0,0,84,77,7,1,0,0,15-2000,Mathematical Science Occupations
40,Oklahoma,171,1133,1040,93,0,0,0,55,51,4,0,0,0,17-1000,"Architects, Surveyors, and Cartographers"
40,Oklahoma,172,17367,15268,2099,46,240,109,751,674,77,1,9,5,17-2000,Engineers
40,Oklahoma,173,7230,6804,426,21,0,45,388,372,16,1,0,3,17-3000,"Drafters, Engineering Technicians, and Mapping Technicians"
40,Oklahoma,191,1519,1160,359,0,22,0,75,63,12,0,1,0,19-1000,Life Scientists
40,Oklahoma,192,4050,3551,499,0,58,0,178,161,17,0,1,0,19-2000,Physical Scientists
40,Oklahoma,193,1529,1478,51,0,0,0,75,73,2,0,0,0,19-3000,Social Scientists and Related Workers
40,Oklahoma,194,3888,3605,283,0,60,88,224,210,14,0,2,5,19-4000,"Life, Physical, and Social Science Technicians"
40,Oklahoma,195,986,964,22,0,0,0,42,41,1,0,0,0,19-5000,Occupational Health and Safety Specialists and Technicians
40,Oklahoma,211,22943,21979,964,169,78,144,1203,1171,32,2,4,7,21-1000,"Counselors, Social Workers, and Other Community and Social Service Specialists"
40,Oklahoma,212,10275,9695,580,37,60,85,501,478,23,2,2,3,21-2000,Religious Workers
40,Oklahoma,231,8116,7958,158,25,17,0,354,347,7,1,1,1,23-1000,"Lawyers, Judges, and Related Workers"
40,Oklahoma,232,6261,6056,205,0,0,131,302,293,9,0,0,6,23-2000,Legal Support Workers
40,Oklahoma,251,14330,11677,2653,3,110,6,630,538,92,1,5,1,25-1000,Postsecondary Teachers
40,Oklahoma,252,60952,59830,1122,8,119,254,3355,3287,68,1,6,17,25-2000,"Preschool, Elementary, Middle, Secondary, and Special Education Teachers"
40,Oklahoma,253,8575,8315,260,0,45,43,446,425,21,0,3,3,25-3000,Other Teachers and Instructors
40,Oklahoma,254,2982,2959,23,0,0,0,164,162,2,0,0,0,25-4000,"Librarians, Curators, and Archivists"
40,Oklahoma,259,14198,12993,1205,118,80,458,811,769,42,1,5,14,25-9000,Other Educational Instruction and Library Occupations
40,Oklahoma,271,7584,6978,606,0,0,0,357,339,18,0,0,0,27-1000,Art and Design Workers
40,Oklahoma,272,6160,5475,685,0,0,44,341,316,25,0,0,2,27-2000,"Entertainers and Performers, Sports and Related Workers"
40,Oklahoma,273,6084,5526,558,0,43,330,303,282,21,0,2,6,27-3000,Media and Communication Workers
40,Oklahoma,274,2431,2400,31,0,0,6,129,126,3,0,0,1,27-4000,Media and Communication Equipment Workers
40,Oklahoma,291,63149,57932,5217,24,364,324,2947,2750,197,2,17,13,29-1000,Healthcare Diagnosing or Treating Practitioners
40,Oklahoma,292,35305,33647,1658,47,66,240,1879,1816,63,2,2,13,29-2000,Health Technologists and Technicians
40,Oklahoma,299,946,886,60,0,0,35,45,42,3,0,0,2,29-9000,Other Healthcare Practitioners and Technical Occupations
40,Oklahoma,3111,30122,28374,1748,39,90,536,1931,1856,75,1,3,22,31-1100,"Home Health and Personal Care Aides; and Nursing Assistants, Orderlies, and Psychiatric Aides"
40,Oklahoma,312,2005,2005,0,0,0,0,103,102,1,0,0,1,31-2000,Occupational Therapy and Physical Therapist Assistants and Aides
40,Oklahoma,319,16775,15949,826,0,25,346,787,752,35,0,1,17,31-9000,Other Healthcare Support Occupations
40,Oklahoma,331,3495,3495,0,0,0,0,181,181,0,0,0,0,33-1000,Supervisors of Protective Service Workers
40,Oklahoma,332,4244,4244,0,0,0,0,235,235,0,0,0,0,33-2000,Firefighting and Prevention Workers
40,Oklahoma,333,13265,12894,371,0,0,149,698,681,17,0,0,8,33-3000,Law Enforcement Workers
40,Oklahoma,339,13107,12892,215,25,0,71,764,752,12,1,0,3,33-9000,Other Protective Service Workers
40,Oklahoma,351,10131,8862,1269,325,25,373,537,493,44,6,2,17,35-1000,Supervisors of Food Preparation and Serving Workers
40,Oklahoma,352,41006,32882,8124,1393,74,5112,2414,2129,285,35,5,192,35-2000,Cooks and Food Preparation Workers
40,Oklahoma,353,40763,37257,3506,545,119,1748,2405,2240,165,10,9,73,35-3000,Food and Beverage Serving Workers
40,Oklahoma,359,10026,8580,1446,182,64,868,596,533,63,7,1,38,35-9000,Other Food Preparation and Serving Related Workers
40,Oklahoma,371,4386,3945,441,20,0,350,237,217,20,1,0,15,37-1000,Supervisors of Building and Grounds Cleaning and Maintenance Workers
40,Oklahoma,372,44053,34741,9312,1184,265,6555,2624,2271,353,42,9,253,37-2000,Building Cleaning and Pest Control Workers
40,Oklahoma,373,15088,10998,4090,316,20,3466,921,785,136,5,1,116,37-3000,Grounds Maintenance Workers
40,Oklahoma,391,2010,1923,87,0,0,0,103,99,4,0,0,0,39-1000,Supervisors of Personal Care and Service Workers
40,Oklahoma,392,4142,3877,265,0,0,175,227,214,13,0,0,9,39-2000,Animal Care and Service Workers
40,Oklahoma,393,3620,3495,125,0,0,52,231,222,9,1,0,3,39-3000,Entertainment Attendants and Related Workers
40,Oklahoma,394,632,632,0,0,0,0,41,41,0,0,0,0,39-4000,Funeral Service Workers
40,Oklahoma,395,15106,12001,3105,26,0,175,660,560,100,2,1,9,39-5000,Personal Appearance Workers
40,Oklahoma,396,445,390,55,0,0,0,20,18,2,0,0,0,39-6000,"Baggage Porters, Bellhops, and Concierges"
40,Oklahoma,397,551,485,66,0,0,0,31,29,2,0,0,0,39-7000,Tour and Travel Guides
40,Oklahoma,399,19122,18558,564,0,132,234,1191,1151,40,1,4,14,39-9000,Other Personal Care and Service Workers
40,Oklahoma,411,51133,47784,3349,87,182,921,2471,2361,110,3,3,36,41-1000,Supervisors of Sales Workers
40,Oklahoma,412,78290,73293,4997,170,128,1704,4724,4492,232,9,9,84,41-2000,Retail Sales Workers
40,Oklahoma,413,11960,11592,368,26,127,79,636,617,19,1,4,5,41-3000,"Sales Representatives, Services"
40,Oklahoma,414,14660,14383,277,15,0,215,696,682,14,2,1,5,41-4000,"Sales Representatives, Wholesale and Manufacturing"
40,Oklahoma,419,11867,11372,495,0,33,60,570,551,19,0,1,4,41-9000,Other Sales and Related Workers
40,Oklahoma,431,15088,14598,490,0,63,129,777,762,15,0,3,4,43-1000,Supervisors of Office and Administrative Support Workers
40,Oklahoma,432,660,639,21,0,0,21,53,52,1,0,0,1,43-2000,Communications Equipment Operators
40,Oklahoma,433,31473,30310,1163,45,98,463,1630,1586,44,3,6,14,43-3000,Financial Clerks
40,Oklahoma,434,57287,54607,2680,274,209,1177,2990,2875,115,7,5,54,43-4000,Information and Record Clerks
40,Oklahoma,435,23822,22807,1015,99,0,395,1275,1230,45,3,0,17,43-5000,"Material Recording, Scheduling, Dispatching, and Distributing Workers"
40,Oklahoma,436,37150,35914,1236,128,63,682,2140,2084,56,4,4,26,43-6000,Secretaries and Administrative Assistants
40,Oklahoma,439,29942,28227,1715,172,150,682,1605,1525,80,6,6,22,43-9000,Other Office and Administrative Support Workers
40,Oklahoma,451,555,496,59,0,0,59,35,30,5,0,2,3,45-1000,"Supervisors of Farming, Fishing, and Forestry Workers"
40,Oklahoma,452,10802,8454,2348,360,4,1661,793,662,131,7,1,93,45-2000,Agricultural Workers
40,Oklahoma,453,87,87,0,0,0,0,5,5,0,0,0,0,45-3000,Fishing and Hunting Workers
40,Oklahoma,454,463,423,40,0,0,40,42,40,2,0,0,2,45-4000,"Forest, Conservation, and Logging Workers"
40,Oklahoma,471,12840,11580,1260,168,0,1070,711,663,48,4,0,42,47-1000,Supervisors of Construction and Extraction Workers
40,Oklahoma,472,83573,63831,19742,2110,114,16943,4369,3721,648,56,4,561,47-2000,Construction Trades Workers
40,Oklahoma,473,372,336,36,13,0,23,24,22,2,1,0,1,47-3000,"Helpers, Construction Trades"
40,Oklahoma,474,4654,4419,235,12,0,207,253,238,15,1,0,13,47-4000,Other Construction and Related Workers
40,Oklahoma,475,10410,9112,1298,102,0,1065,697,644,53,2,0,38,47-5000,Extraction Workers
40,Oklahoma,491,4166,4033,133,0,19,84,215,209,6,0,1,4,49-1000,"Supervisors of Installation, Maintenance, and Repair Workers"
40,Oklahoma,492,6783,6604,179,0,5,56,329,318,11,1,1,4,49-2000,"Electrical and Electronic Equipment Mechanics, Installers, and Repairers"
40,Oklahoma,493,29295,27405,1890,282,27,1207,1548,1469,79,9,2,49,49-3000,"Vehicle and Mobile Equipment Mechanics, Installers, and Repairers"
40,Oklahoma,499,26876,25894,982,74,0,436,1527,1478,49,3,0,21,49-9000,"Other Installation, Maintenance, and Repair Occupations"
40,Oklahoma,511,11902,11067,835,0,31,485,686,653,33,0,2,19,51-1000,Supervisors of Production Workers
40,Oklahoma,512,13339,9536,3803,140,13,1729,691,555,136,5,1,55,51-2000,Assemblers and Fabricators
40,Oklahoma,513,7285,5251,2034,222,9,1302,387,321,66,5,1,42,51-3000,Food Processing Workers
40,Oklahoma,514,29545,25016,4529,137,25,2692,1695,1512,183,4,1,123,51-4000,Metal Workers and Plastic Workers
40,Oklahoma,5151,2057,1966,91,0,0,48,97,94,3,0,0,2,51-5100,Printing Workers
40,Oklahoma,516,5474,3903,1571,95,83,1112,301,234,67,3,2,42,51-6000,"Textile, Apparel, and Furnishings Workers"
40,Oklahoma,517,795,751,44,0,0,44,58,55,3,0,0,3,51-7000,Woodworkers
40,Oklahoma,518,4461,4363,98,0,0,49,241,235,6,0,0,2,51-8000,Plant and System Operators
40,Oklahoma,519,37599,33384,4215,179,69,2956,2050,1869,181,8,4,117,51-9000,Other Production Occupations
40,Oklahoma,531,3192,2896,296,0,0,125,148,138,10,0,0,3,53-1000,Supervisors of Transportation and Material Moving Workers
40,Oklahoma,532,2111,2041,70,0,0,0,87,83,4,0,0,0,53-2000,Air Transportation Workers
40,Oklahoma,533,50343,47640,2703,124,46,1517,2858,2760,98,7,3,52,53-3000,Motor Vehicle Operators
40,Oklahoma,534,1286,1264,22,0,0,0,80,79,1,0,0,0,53-4000,Rail Transportation Workers
40,Oklahoma,535,46,46,0,0,0,0,3,3,0,0,0,0,53-5000,Water Transportation Workers
40,Oklahoma,536,2777,2743,34,0,0,12,164,162,2,0,0,1,53-6000,Other Transportation Workers
40,Oklahoma,537,68444,61620,6824,339,75,3872,3854,3580,274,18,5,177,53-7000,Material Moving Workers
41,Oregon,111,25764,23239,2525,54,35,560,1419,1309,110,3,1,16,11-1000,Top Executives
41,Oregon,112,13026,12055,971,19,44,59,759,700,59,1,3,3,11-2000,"Advertising, Marketing, Promotions, Public Relations, and Sales Managers"
41,Oregon,113,34724,31320,3404,104,252,487,2019,1853,166,5,11,19,11-3000,Operations Specialties Managers
41,Oregon,119,123386,110223,13163,436,485,3779,7105,6490,615,12,21,137,11-9000,Other Management Occupations
41,Oregon,131,59008,53753,5255,13,248,838,3415,3163,252,2,10,23,13-1000,Business Operations Specialists
41,Oregon,132,34375,31321,3054,0,132,249,1977,1807,170,1,5,13,13-2000,Financial Specialists
41,Oregon,1512,58603,48692,9911,89,277,301,3202,2719,483,4,18,17,15-1200,Computer Occupations
41,Oregon,152,3046,2387,659,0,15,0,177,147,30,0,1,0,15-2000,Mathematical Science Occupations
41,Oregon,171,4029,3871,158,15,0,0,230,220,10,1,1,0,17-1000,"Architects, Surveyors, and Cartographers"
41,Oregon,172,30919,23415,7504,48,183,315,1672,1314,358,3,9,11,17-2000,Engineers
41,Oregon,173,9597,8185,1412,46,47,322,554,495,59,1,2,8,17-3000,"Drafters, Engineering Technicians, and Mapping Technicians"
41,Oregon,191,6029,5069,960,0,46,70,366,325,41,0,4,1,19-1000,Life Scientists
41,Oregon,192,5033,4013,1020,0,13,21,292,240,52,0,1,1,19-2000,Physical Scientists
41,Oregon,193,4324,3981,343,0,40,0,252,230,22,0,2,1,19-3000,Social Scientists and Related Workers
41,Oregon,194,5464,4904,560,0,26,245,344,312,32,0,2,11,19-4000,"Life, Physical, and Social Science Technicians"
41,Oregon,195,591,528,63,0,0,38,32,30,2,0,0,1,19-5000,Occupational Health and Safety Specialists and Technicians
41,Oregon,211,32092,29196,2896,197,389,823,1775,1645,130,5,17,32,21-1000,"Counselors, Social Workers, and Other Community and Social Service Specialists"
41,Oregon,212,6664,6212,452,91,0,88,405,379,26,2,0,5,21-2000,Religious Workers
41,Oregon,231,10928,10257,671,11,66,24,615,585,30,1,3,1,23-1000,"Lawyers, Judges, and Related Workers"
41,Oregon,232,7498,7001,497,0,36,133,431,409,22,0,2,5,23-2000,Legal Support Workers
41,Oregon,251,18578,15455,3123,50,235,80,1139,963,176,2,9,7,25-1000,Postsecondary Teachers
41,Oregon,252,54159,50893,3266,49,378,755,3403,3206,197,2,16,45,25-2000,"Preschool, Elementary, Middle, Secondary, and Special Education Teachers"
41,Oregon,253,11460,10657,803,19,0,136,772,706,66,2,1,7,25-3000,Other Teachers and Instructors
41,Oregon,254,3767,3411,356,0,16,33,244,228,16,0,1,2,25-4000,"Librarians, Curators, and Archivists"
41,Oregon,259,17676,15524,2152,104,190,725,1122,1009,113,3,9,37,25-9000,Other Educational Instruction and Library Occupations
41,Oregon,271,18197,16541,1656,56,20,166,1069,974,95,4,1,10,27-1000,Art and Design Workers
41,Oregon,272,8979,8286,693,39,0,63,619,581,38,2,0,3,27-2000,"Entertainers and Performers, Sports and Related Workers"
41,Oregon,273,13051,11422,1629,64,88,142,795,693,102,5,3,8,27-3000,Media and Communication Workers
41,Oregon,274,4270,4050,220,0,0,22,286,264,22,0,1,4,27-4000,Media and Communication Equipment Workers
41,Oregon,291,75621,68614,7007,60,146,507,4233,3869,364,3,9,20,29-1000,Healthcare Diagnosing or Treating Practitioners
41,Oregon,292,31063,28147,2916,42,80,502,1694,1564,130,4,3,14,29-2000,Health Technologists and Technicians
41,Oregon,299,626,573,53,0,0,0,44,42,2,0,0,0,29-9000,Other Healthcare Practitioners and Technical Occupations
41,Oregon,3111,52259,44168,8091,299,181,1626,2888,2522,366,10,7,70,31-1100,"Home Health and Personal Care Aides; and Nursing Assistants, Orderlies, and Psychiatric Aides"
41,Oregon,312,1463,1440,23,0,0,0,90,88,2,0,0,0,31-2000,Occupational Therapy and Physical Therapist Assistants and Aides
41,Oregon,319,24407,22416,1991,12,0,844,1314,1224,90,1,0,28,31-9000,Other Healthcare Support Occupations
41,Oregon,331,3031,2968,63,0,0,31,206,203,3,0,0,1,33-1000,Supervisors of Protective Service Workers
41,Oregon,332,4966,4579,387,29,0,321,334,320,14,1,0,9,33-2000,Firefighting and Prevention Workers
41,Oregon,333,10868,10589,279,15,0,61,628,604,24,1,0,4,33-3000,Law Enforcement Workers
41,Oregon,339,11638,10990,648,0,34,197,755,713,42,0,2,12,33-9000,Other Protective Service Workers
41,Oregon,351,14668,11408,3260,36,21,1599,707,600,107,1,1,43,35-1000,Supervisors of Food Preparation and Serving Workers
41,Oregon,352,51066,39913,11153,814,122,7255,2738,2349,389,22,7,206,35-2000,Cooks and Food Preparation Workers
41,Oregon,353,44669,39979,4690,217,226,1596,2583,2363,220,2,9,63,35-3000,Food and Beverage Serving Workers
41,Oregon,359,10783,8980,1803,374,86,1025,780,698,82,11,5,39,35-9000,Other Food Preparation and Serving Related Workers
41,Oregon,371,4604,3315,1289,74,0,1017,217,180,37,1,0,25,37-1000,Supervisors of Building and Grounds Cleaning and Maintenance Workers
41,Oregon,372,41162,29994,11168,1049,145,6977,2549,2102,447,35,9,259,37-2000,Building Cleaning and Pest Control Workers
41,Oregon,373,17397,11329,6068,230,0,5406,998,806,192,9,0,164,37-3000,Grounds Maintenance Workers
41,Oregon,391,1103,994,109,0,0,0,68,62,6,0,0,0,39-1000,Supervisors of Personal Care and Service Workers
41,Oregon,392,4275,4137,138,0,43,29,268,259,9,1,1,3,39-2000,Animal Care and Service Workers
41,Oregon,393,3374,3024,350,0,0,19,228,216,12,0,0,2,39-3000,Entertainment Attendants and Related Workers
41,Oregon,394,359,359,0,0,0,0,19,19,0,0,0,0,39-4000,Funeral Service Workers
41,Oregon,395,13051,10342,2709,18,21,211,668,545,123,2,2,10,39-5000,Personal Appearance Workers
41,Oregon,396,706,638,68,0,0,0,30,27,3,0,0,0,39-6000,"Baggage Porters, Bellhops, and Concierges"
41,Oregon,397,722,722,0,0,0,0,76,74,2,1,0,0,39-7000,Tour and Travel Guides
41,Oregon,399,22887,19981,2906,194,205,1116,1641,1499,142,5,8,48,39-9000,Other Personal Care and Service Workers
41,Oregon,411,52972,48579,4393,112,155,1281,2848,2630,218,6,7,62,41-1000,Supervisors of Sales Workers
41,Oregon,412,75131,67697,7434,326,100,2603,4723,4368,355,13,10,91,41-2000,Retail Sales Workers
41,Oregon,413,16693,15693,1000,13,69,180,903,852,51,1,3,6,41-3000,"Sales Representatives, Services"
41,Oregon,414,16247,15528,719,14,14,21,899,859,40,1,1,1,41-4000,"Sales Representatives, Wholesale and Manufacturing"
41,Oregon,419,17168,15920,1248,0,35,242,954,902,52,1,2,8,41-9000,Other Sales and Related Workers
41,Oregon,431,14089,13064,1025,101,48,375,813,760,53,2,3,17,43-1000,Supervisors of Office and Administrative Support Workers
41,Oregon,432,1072,948,124,0,17,0,53,48,5,0,1,0,43-2000,Communications Equipment Operators
41,Oregon,433,30332,28273,2059,95,178,574,1796,1676,120,7,9,28,43-3000,Financial Clerks
41,Oregon,434,69818,65382,4436,137,239,1261,4064,3820,244,7,15,57,43-4000,Information and Record Clerks
41,Oregon,435,26360,23221,3139,23,155,1015,1446,1316,130,2,6,35,43-5000,"Material Recording, Scheduling, Dispatching, and Distributing Workers"
41,Oregon,436,33779,31887,1892,90,133,462,2123,2015,108,5,7,21,43-6000,Secretaries and Administrative Assistants
41,Oregon,439,34019,31570,2449,92,89,603,2109,1985,124,5,5,29,43-9000,Other Office and Administrative Support Workers
41,Oregon,451,2323,1619,704,0,47,641,126,97,29,0,1,27,45-1000,"Supervisors of Farming, Fishing, and Forestry Workers"
41,Oregon,452,24656,9445,15211,838,84,13807,1435,869,566,19,5,512,45-2000,Agricultural Workers
41,Oregon,453,1351,1176,175,0,59,0,111,108,3,0,1,0,45-3000,Fishing and Hunting Workers
41,Oregon,454,4595,3978,617,0,26,565,285,265,20,0,1,17,45-4000,"Forest, Conservation, and Logging Workers"
41,Oregon,471,9234,8266,968,19,25,548,509,467,42,1,1,21,47-1000,Supervisors of Construction and Extraction Workers
41,Oregon,472,73190,59135,14055,987,274,10378,3907,3479,428,26,8,277,47-2000,Construction Trades Workers
41,Oregon,473,203,203,0,0,0,0,16,15,1,0,0,1,47-3000,"Helpers, Construction Trades"
41,Oregon,474,3475,3148,327,0,0,254,241,229,12,0,0,7,47-4000,Other Construction and Related Workers
41,Oregon,475,713,684,29,0,0,15,47,45,2,0,0,1,47-5000,Extraction Workers
41,Oregon,491,2828,2463,365,30,84,60,156,145,11,1,1,2,49-1000,"Supervisors of Installation, Maintenance, and Repair Workers"
41,Oregon,492,4847,4410,437,29,0,56,279,263,16,1,0,3,49-2000,"Electrical and Electronic Equipment Mechanics, Installers, and Repairers"
41,Oregon,493,18030,15677,2353,87,12,1420,1023,931,92,4,1,40,49-3000,"Vehicle and Mobile Equipment Mechanics, Installers, and Repairers"
41,Oregon,499,23256,20661,2595,51,35,1528,1325,1224,101,4,1,52,49-9000,"Other Installation, Maintenance, and Repair Occupations"
41,Oregon,511,10116,8346,1770,16,126,1171,534,472,62,1,3,38,51-1000,Supervisors of Production Workers
41,Oregon,512,12134,8107,4027,126,0,1865,622,461,161,5,0,56,51-2000,Assemblers and Fabricators
41,Oregon,513,10775,7428,3347,142,34,2366,524,412,112,5,2,73,51-3000,Food Processing Workers
41,Oregon,514,16695,13722,2973,138,0,995,905,771,134,3,0,39,51-4000,Metal Workers and Plastic Workers
41,Oregon,5151,2524,2180,344,0,0,240,141,126,15,0,0,8,51-5100,Printing Workers
41,Oregon,516,5825,3461,2364,370,0,1091,313,209,104,9,0,44,51-6000,"Textile, Apparel, and Furnishings Workers"
41,Oregon,517,3847,3109,738,79,0,573,231,199,32,3,0,22,51-7000,Woodworkers
41,Oregon,518,2474,2246,228,0,17,78,150,139,11,0,1,2,51-8000,Plant and System Operators
41,Oregon,519,41645,32540,9105,415,85,5157,2181,1824,357,10,4,183,51-9000,Other Production Occupations
41,Oregon,531,3087,2821,266,0,0,150,165,155,10,0,0,3,53-1000,Supervisors of Transportation and Material Moving Workers
41,Oregon,532,2934,2706,228,0,38,0,142,130,12,0,2,0,53-2000,Air Transportation Workers
41,Oregon,533,49250,43185,6065,399,206,2157,2735,2491,244,15,9,83,53-3000,Motor Vehicle Operators
41,Oregon,534,1298,1235,63,0,0,0,71,68,3,0,0,0,53-4000,Rail Transportation Workers
41,Oregon,535,691,666,25,0,0,0,39,36,3,0,0,0,53-5000,Water Transportation Workers
41,Oregon,536,6980,6477,503,0,0,178,422,399,23,0,0,8,53-6000,Other Transportation Workers
41,Oregon,537,69101,58447,10654,791,193,6303,3894,3473,421,23,8,226,53-7000,Material Moving Workers
42,Pennsylvania,111,73011,67677,5334,54,530,154,3869,3631,238,3,21,5,11-1000,Top Executives
42,Pennsylvania,112,40691,38337,2354,64,194,46,2026,1923,103,2,6,2,11-2000,"Advertising, Marketing, Promotions, Public Relations, and Sales Managers"
42,Pennsylvania,113,119600,110170,9430,254,524,177,6249,5853,396,3,20,8,11-3000,Operations Specialties Managers
42,Pennsylvania,119,325385,300891,24494,1239,1746,1113,17573,16637,936,26,60,32,11-9000,Other Management Occupations
42,Pennsylvania,131,189609,176056,13553,342,864,657,9826,9221,605,12,33,21,13-1000,Business Operations Specialists
42,Pennsylvania,132,124724,115726,8998,155,457,400,6539,6148,391,4,19,13,13-2000,Financial Specialists
42,Pennsylvania,1512,165333,136714,28619,141,1367,373,8203,7072,1131,9,39,12,15-1200,Computer Occupations
42,Pennsylvania,152,10955,9040,1915,0,119,0,562,481,81,0,4,0,15-2000,Mathematical Science Occupations
42,Pennsylvania,171,7994,7032,962,35,105,0,401,359,42,1,3,0,17-1000,"Architects, Surveyors, and Cartographers"
42,Pennsylvania,172,70297,61332,8965,80,432,303,3678,3325,353,3,20,9,17-2000,Engineers
42,Pennsylvania,173,25172,23508,1664,13,160,19,1566,1492,74,2,8,1,17-3000,"Drafters, Engineering Technicians, and Mapping Technicians"
42,Pennsylvania,191,11144,7975,3169,59,95,42,591,446,145,3,5,2,19-1000,Life Scientists
42,Pennsylvania,192,20904,16138,4766,0,46,10,1022,810,212,0,5,1,19-2000,Physical Scientists
42,Pennsylvania,193,10444,9598,846,4,48,0,528,497,31,1,2,0,19-3000,Social Scientists and Related Workers
42,Pennsylvania,194,14239,12784,1455,46,169,66,1014,903,111,1,4,5,19-4000,"Life, Physical, and Social Science Technicians"
42,Pennsylvania,195,3635,3486,149,0,15,12,181,175,6,0,1,1,19-5000,Occupational Health and Safety Specialists and Technicians
42,Pennsylvania,211,97431,91404,6027,51,367,247,5198,4962,236,4,20,14,21-1000,"Counselors, Social Workers, and Other Community and Social Service Specialists"
42,Pennsylvania,212,18955,17095,1860,0,206,98,1248,1158,90,0,10,6,21-2000,Religious Workers
42,Pennsylvania,231,40262,39147,1115,16,84,0,1962,1905,57,1,5,0,23-1000,"Lawyers, Judges, and Related Workers"
42,Pennsylvania,232,21323,20059,1264,96,19,156,1080,1026,54,3,2,5,23-2000,Legal Support Workers
42,Pennsylvania,251,59741,45380,14361,194,437,49,3242,2581,661,7,25,5,25-1000,Postsecondary Teachers
42,Pennsylvania,252,199121,193509,5612,252,365,249,11615,11306,309,6,19,17,25-2000,"Preschool, Elementary, Middle, Secondary, and Special Education Teachers"
42,Pennsylvania,253,31217,28636,2581,41,189,223,2011,1858,153,4,8,5,25-3000,Other Teachers and Instructors
42,Pennsylvania,254,9441,8928,513,0,0,0,558,533,25,0,0,0,25-4000,"Librarians, Curators, and Archivists"
42,Pennsylvania,259,46120,42562,3558,219,143,175,3059,2856,203,9,8,9,25-9000,Other Educational Instruction and Library Occupations
42,Pennsylvania,271,33531,31129,2402,0,204,143,1906,1788,118,0,9,4,27-1000,Art and Design Workers
42,Pennsylvania,272,23112,21542,1570,26,90,146,1541,1464,77,1,8,3,27-2000,"Entertainers and Performers, Sports and Related Workers"
42,Pennsylvania,273,27903,26023,1880,0,408,177,1522,1426,96,1,9,4,27-3000,Media and Communication Workers
42,Pennsylvania,274,10136,9634,502,48,28,69,624,601,23,1,1,2,27-4000,Media and Communication Equipment Workers
42,Pennsylvania,291,285635,257794,27841,199,1243,72,15072,13908,1164,6,54,4,29-1000,Healthcare Diagnosing or Treating Practitioners
42,Pennsylvania,292,128225,118840,9385,229,214,144,7336,6991,345,9,10,6,29-2000,Health Technologists and Technicians
42,Pennsylvania,299,3660,3401,259,0,0,110,194,184,10,0,0,4,29-9000,Other Healthcare Practitioners and Technical Occupations
42,Pennsylvania,3111,157270,138436,18834,275,1359,464,8171,7512,659,15,38,15,31-1100,"Home Health and Personal Care Aides; and Nursing Assistants, Orderlies, and Psychiatric Aides"
42,Pennsylvania,312,7439,7266,173,0,0,0,451,444,7,0,0,0,31-2000,Occupational Therapy and Physical Therapist Assistants and Aides
42,Pennsylvania,319,52290,48062,4228,54,245,59,2877,2726,151,1,11,4,31-9000,Other Healthcare Support Occupations
42,Pennsylvania,331,7820,7604,216,0,0,0,513,505,8,0,1,0,33-1000,Supervisors of Protective Service Workers
42,Pennsylvania,332,6101,5991,110,0,44,0,311,307,4,0,1,0,33-2000,Firefighting and Prevention Workers
42,Pennsylvania,333,52930,51305,1625,277,136,0,2961,2896,65,7,5,1,33-3000,Law Enforcement Workers
42,Pennsylvania,339,47859,45836,2023,67,231,101,3135,3031,104,4,9,4,33-9000,Other Protective Service Workers
42,Pennsylvania,351,36348,31174,5174,70,190,360,1816,1622,194,3,6,8,35-1000,Supervisors of Food Preparation and Serving Workers
42,Pennsylvania,352,120018,104445,15573,1647,577,3667,7522,6954,568,53,13,95,35-2000,Cooks and Food Preparation Workers
42,Pennsylvania,353,133778,125918,7860,335,377,926,8453,8076,377,16,21,28,35-3000,Food and Beverage Serving Workers
42,Pennsylvania,359,41802,38549,3253,233,85,792,3166,3015,151,8,9,22,35-9000,Other Food Preparation and Serving Related Workers
42,Pennsylvania,371,13536,12604,932,49,355,109,717,682,35,2,8,5,37-1000,Supervisors of Building and Grounds Cleaning and Maintenance Workers
42,Pennsylvania,372,138266,118260,20006,1117,3481,2820,8347,7663,684,37,103,100,37-2000,Building Cleaning and Pest Control Workers
42,Pennsylvania,373,37380,32908,4472,612,278,2765,2756,2625,131,15,8,60,37-3000,Grounds Maintenance Workers
42,Pennsylvania,391,3411,2886,525,0,21,0,189,164,25,0,1,0,39-1000,Supervisors of Personal Care and Service Workers
42,Pennsylvania,392,11399,11024,375,0,116,118,750,730,20,0,3,4,39-2000,Animal Care and Service Workers
42,Pennsylvania,393,15170,13840,1330,0,229,0,1055,1008,47,0,5,0,39-3000,Entertainment Attendants and Related Workers
42,Pennsylvania,394,2498,2459,39,0,0,0,147,145,2,0,0,0,39-4000,Funeral Service Workers
42,Pennsylvania,395,46314,36505,9809,83,206,102,2237,1900,337,3,6,7,39-5000,Personal Appearance Workers
42,Pennsylvania,396,2085,1784,301,0,0,0,89,81,8,0,0,0,39-6000,"Baggage Porters, Bellhops, and Concierges"
42,Pennsylvania,397,2278,2053,225,17,88,32,172,160,12,2,3,1,39-7000,Tour and Travel Guides
42,Pennsylvania,399,70986,65176,5810,291,648,287,5255,4972,283,11,28,17,39-9000,Other Personal Care and Service Workers
42,Pennsylvania,411,156139,144566,11573,465,403,322,8303,7866,437,12,20,12,41-1000,Supervisors of Sales Workers
42,Pennsylvania,412,236714,220064,16650,741,932,773,15687,14910,777,21,40,27,41-2000,Retail Sales Workers
42,Pennsylvania,413,56863,54478,2385,59,206,20,2890,2779,111,3,9,2,41-3000,"Sales Representatives, Services"
42,Pennsylvania,414,52551,50970,1581,40,139,129,2799,2729,70,2,5,5,41-4000,"Sales Representatives, Wholesale and Manufacturing"
42,Pennsylvania,419,39264,36953,2311,83,246,0,2246,2123,123,4,10,2,41-9000,Other Sales and Related Workers
42,Pennsylvania,431,49298,46936,2362,31,278,35,2724,2619,105,2,12,3,43-1000,Supervisors of Office and Administrative Support Workers
42,Pennsylvania,432,2966,2822,144,0,0,48,160,154,6,0,0,1,43-2000,Communications Equipment Operators
42,Pennsylvania,433,92309,87259,5050,86,326,171,5354,5141,213,2,11,3,43-3000,Financial Clerks
42,Pennsylvania,434,189159,177925,11234,344,926,328,10849,10373,476,12,36,17,43-4000,Information and Record Clerks
42,Pennsylvania,435,80790,73652,7138,388,503,470,4708,4487,221,11,23,14,43-5000,"Material Recording, Scheduling, Dispatching, and Distributing Workers"
42,Pennsylvania,436,129624,125139,4485,102,622,370,8514,8270,244,6,24,14,43-6000,Secretaries and Administrative Assistants
42,Pennsylvania,439,120001,113406,6595,149,335,157,7136,6806,330,9,18,9,43-9000,Other Office and Administrative Support Workers
42,Pennsylvania,451,1035,858,177,0,0,138,78,69,9,0,0,7,45-1000,"Supervisors of Farming, Fishing, and Forestry Workers"
42,Pennsylvania,452,20898,15329,5569,821,62,4146,1602,1344,258,22,6,194,45-2000,Agricultural Workers
42,Pennsylvania,453,85,85,0,0,0,0,13,12,1,0,0,1,45-3000,Fishing and Hunting Workers
42,Pennsylvania,454,3737,3737,0,0,0,0,350,350,0,0,0,0,45-4000,"Forest, Conservation, and Logging Workers"
42,Pennsylvania,471,26671,26042,629,64,130,128,1727,1702,25,1,4,5,47-1000,Supervisors of Construction and Extraction Workers
42,Pennsylvania,472,218229,197726,20503,3596,1992,4783,13515,12945,570,68,52,116,47-2000,Construction Trades Workers
42,Pennsylvania,473,878,813,65,20,0,0,75,66,9,1,0,0,47-3000,"Helpers, Construction Trades"
42,Pennsylvania,474,14686,13910,776,44,59,45,957,933,24,2,2,1,47-4000,Other Construction and Related Workers
42,Pennsylvania,475,9716,9225,491,129,0,98,775,758,17,4,0,2,47-5000,Extraction Workers
42,Pennsylvania,491,9985,9644,341,0,0,81,603,591,12,0,0,1,49-1000,"Supervisors of Installation, Maintenance, and Repair Workers"
42,Pennsylvania,492,16674,15653,1021,24,156,22,899,860,39,1,3,1,49-2000,"Electrical and Electronic Equipment Mechanics, Installers, and Repairers"
42,Pennsylvania,493,74991,71530,3461,41,418,212,4316,4196,120,4,13,4,49-3000,"Vehicle and Mobile Equipment Mechanics, Installers, and Repairers"
42,Pennsylvania,499,86963,82144,4819,429,265,297,5213,5039,174,10,10,7,49-9000,"Other Installation, Maintenance, and Repair Occupations"
42,Pennsylvania,511,37743,34907,2836,219,110,219,2268,2151,117,7,9,9,51-1000,Supervisors of Production Workers
42,Pennsylvania,512,41530,35362,6168,23,373,276,2518,2303,215,2,12,12,51-2000,Assemblers and Fabricators
42,Pennsylvania,513,28209,24229,3980,139,148,246,1641,1501,140,8,9,11,51-3000,Food Processing Workers
42,Pennsylvania,514,76338,71463,4875,739,191,529,5002,4840,162,15,10,12,51-4000,Metal Workers and Plastic Workers
42,Pennsylvania,5151,10067,9354,713,32,0,0,588,567,21,1,0,0,51-5100,Printing Workers
42,Pennsylvania,516,17015,12477,4538,120,203,398,958,793,165,7,10,13,51-6000,"Textile, Apparel, and Furnishings Workers"
42,Pennsylvania,517,7588,7316,272,0,11,21,545,529,16,0,2,1,51-7000,Woodworkers
42,Pennsylvania,518,11484,11153,331,80,39,0,724,711,13,1,1,0,51-8000,Plant and System Operators
42,Pennsylvania,519,135413,117700,17713,1061,1351,1775,8020,7392,628,35,42,58,51-9000,Other Production Occupations
42,Pennsylvania,531,9837,9296,541,70,47,0,502,478,24,1,3,0,53-1000,Supervisors of Transportation and Material Moving Workers
42,Pennsylvania,532,6565,6333,232,0,31,0,350,337,13,0,1,0,53-2000,Air Transportation Workers
42,Pennsylvania,533,176004,159128,16876,628,1320,784,10300,9746,554,23,42,27,53-3000,Motor Vehicle Operators
42,Pennsylvania,534,3587,3516,71,0,0,0,246,241,5,0,0,0,53-4000,Rail Transportation Workers
42,Pennsylvania,535,844,844,0,0,0,0,59,59,0,0,0,0,53-5000,Water Transportation Workers
42,Pennsylvania,536,10240,9103,1137,0,28,21,538,504,34,0,2,1,53-6000,Other Transportation Workers
42,Pennsylvania,537,261511,236407,25104,1726,1797,2249,16417,15476,941,61,67,96,53-7000,Material Moving Workers
44,Rhode Island,111,6684,5996,688,31,0,11,390,358,32,1,0,1,11-1000,Top Executives
44,Rhode Island,112,3530,3093,437,0,19,14,222,199,23,0,1,1,11-2000,"Advertising, Marketing, Promotions, Public Relations, and Sales Managers"
44,Rhode Island,113,10375,9154,1221,126,198,0,585,523,62,6,7,0,11-3000,Operations Specialties Managers
44,Rhode Island,119,26779,23616,3163,159,165,23,1537,1388,149,10,9,1,11-9000,Other Management Occupations
44,Rhode Island,131,15714,14085,1629,199,67,60,913,834,79,5,5,1,13-1000,Business Operations Specialists
44,Rhode Island,132,9905,9329,576,0,0,9,587,551,36,1,0,1,13-2000,Financial Specialists
44,Rhode Island,1512,13641,10724,2917,118,163,0,794,670,124,2,9,0,15-1200,Computer Occupations
44,Rhode Island,152,806,702,104,0,0,0,43,37,6,0,0,0,15-2000,Mathematical Science Occupations
44,Rhode Island,171,916,894,22,0,0,0,59,58,1,0,0,0,17-1000,"Architects, Surveyors, and Cartographers"
44,Rhode Island,172,7754,6745,1009,120,118,0,410,366,44,3,4,0,17-2000,Engineers
44,Rhode Island,173,2064,1835,229,0,13,32,125,108,17,0,1,2,17-3000,"Drafters, Engineering Technicians, and Mapping Technicians"
44,Rhode Island,191,624,361,263,0,0,0,49,30,19,0,1,0,19-1000,Life Scientists
44,Rhode Island,192,1678,1268,410,0,0,99,95,78,17,0,0,1,19-2000,Physical Scientists
44,Rhode Island,193,1374,1206,168,111,0,17,77,73,4,1,0,1,19-3000,Social Scientists and Related Workers
44,Rhode Island,194,1080,994,86,0,0,19,94,88,6,0,0,1,19-4000,"Life, Physical, and Social Science Technicians"
44,Rhode Island,195,130,130,0,0,0,0,7,7,0,0,0,0,19-5000,Occupational Health and Safety Specialists and Technicians
44,Rhode Island,211,9540,8295,1245,53,293,11,515,461,54,3,13,1,21-1000,"Counselors, Social Workers, and Other Community and Social Service Specialists"
44,Rhode Island,212,1609,1174,435,22,0,0,100,81,19,1,0,0,21-2000,Religious Workers
44,Rhode Island,231,2950,2855,95,0,0,0,174,168,6,0,0,0,23-1000,"Lawyers, Judges, and Related Workers"
44,Rhode Island,232,1836,1666,170,58,0,0,108,98,10,1,1,0,23-2000,Legal Support Workers
44,Rhode Island,251,7607,5803,1804,18,27,81,467,360,107,1,3,4,25-1000,Postsecondary Teachers
44,Rhode Island,252,18508,17304,1204,28,141,22,1057,986,71,2,9,2,25-2000,"Preschool, Elementary, Middle, Secondary, and Special Education Teachers"
44,Rhode Island,253,2659,2440,219,0,0,0,201,189,12,1,1,0,25-3000,Other Teachers and Instructors
44,Rhode Island,254,1610,1513,97,36,0,0,103,97,6,2,0,0,25-4000,"Librarians, Curators, and Archivists"
44,Rhode Island,259,4950,4077,873,32,139,0,315,275,40,1,6,0,25-9000,Other Educational Instruction and Library Occupations
44,Rhode Island,271,4095,3598,497,15,133,0,267,242,25,1,2,0,27-1000,Art and Design Workers
44,Rhode Island,272,2644,2546,98,0,11,9,187,175,12,0,1,1,27-2000,"Entertainers and Performers, Sports and Related Workers"
44,Rhode Island,273,2309,2060,249,53,22,0,152,138,14,1,1,0,27-3000,Media and Communication Workers
44,Rhode Island,274,1188,1114,74,52,0,0,81,76,5,1,0,0,27-4000,Media and Communication Equipment Workers
44,Rhode Island,291,23067,20694,2373,65,232,31,1342,1198,144,4,13,2,29-1000,Healthcare Diagnosing or Treating Practitioners
44,Rhode Island,292,9529,8402,1127,51,69,17,508,454,54,2,4,1,29-2000,Health Technologists and Technicians
44,Rhode Island,299,252,235,17,0,0,0,16,14,2,0,0,0,29-9000,Other Healthcare Practitioners and Technical Occupations
44,Rhode Island,3111,15035,10127,4908,230,77,33,678,483,195,10,6,2,31-1100,"Home Health and Personal Care Aides; and Nursing Assistants, Orderlies, and Psychiatric Aides"
44,Rhode Island,312,731,686,45,0,0,0,41,38,3,0,0,0,31-2000,Occupational Therapy and Physical Therapist Assistants and Aides
44,Rhode Island,319,4871,3969,902,81,124,0,265,219,46,4,6,0,31-9000,Other Healthcare Support Occupations
44,Rhode Island,331,961,860,101,0,101,0,47,45,2,0,2,0,33-1000,Supervisors of Protective Service Workers
44,Rhode Island,332,1666,1646,20,20,0,0,80,79,1,1,0,0,33-2000,Firefighting and Prevention Workers
44,Rhode Island,333,3610,3408,202,26,32,0,189,178,11,1,1,0,33-3000,Law Enforcement Workers
44,Rhode Island,339,4327,3727,600,16,60,0,295,274,21,1,2,0,33-9000,Other Protective Service Workers
44,Rhode Island,351,4432,3733,699,142,0,0,223,196,27,4,0,0,35-1000,Supervisors of Food Preparation and Serving Workers
44,Rhode Island,352,9582,7483,2099,519,221,163,594,504,90,20,8,3,35-2000,Cooks and Food Preparation Workers
44,Rhode Island,353,14000,12975,1025,109,114,15,855,792,63,4,9,1,35-3000,Food and Beverage Serving Workers
44,Rhode Island,359,3713,3207,506,76,13,0,319,290,29,5,1,0,35-9000,Other Food Preparation and Serving Related Workers
44,Rhode Island,371,924,602,322,81,17,0,50,37,13,4,1,0,37-1000,Supervisors of Building and Grounds Cleaning and Maintenance Workers
44,Rhode Island,372,12522,7299,5223,1157,490,202,653,445,208,34,27,11,37-2000,Building Cleaning and Pest Control Workers
44,Rhode Island,373,5094,3491,1603,935,41,69,254,197,57,26,2,4,37-3000,Grounds Maintenance Workers
44,Rhode Island,391,381,352,29,0,0,0,21,19,2,0,0,0,39-1000,Supervisors of Personal Care and Service Workers
44,Rhode Island,392,1510,1378,132,31,0,0,68,66,2,1,0,0,39-2000,Animal Care and Service Workers
44,Rhode Island,393,1358,1256,102,0,0,0,89,82,7,0,0,0,39-3000,Entertainment Attendants and Related Workers
44,Rhode Island,394,56,56,0,0,0,0,6,6,0,0,0,0,39-4000,Funeral Service Workers
44,Rhode Island,395,3887,3029,858,0,28,0,185,148,37,0,1,0,39-5000,Personal Appearance Workers
44,Rhode Island,396,207,173,34,0,0,0,11,10,1,0,0,0,39-6000,"Baggage Porters, Bellhops, and Concierges"
44,Rhode Island,397,286,272,14,0,0,0,21,20,1,0,0,0,39-7000,Tour and Travel Guides
44,Rhode Island,399,6906,5808,1098,0,104,0,522,463,59,0,6,0,39-9000,Other Personal Care and Service Workers
44,Rhode Island,411,15820,14512,1308,109,57,0,835,761,74,2,5,2,41-1000,Supervisors of Sales Workers
44,Rhode Island,412,21719,19529,2190,53,177,59,1394,1267,127,4,13,4,41-2000,Retail Sales Workers
44,Rhode Island,413,4157,3697,460,0,0,0,235,215,20,0,1,0,41-3000,"Sales Representatives, Services"
44,Rhode Island,414,4569,4195,374,9,93,0,245,226,19,1,5,0,41-4000,"Sales Representatives, Wholesale and Manufacturing"
44,Rhode Island,419,3417,2833,584,24,172,0,201,179,22,1,3,0,41-9000,Other Sales and Related Workers
44,Rhode Island,431,3393,3205,188,0,5,0,187,175,12,0,1,0,43-1000,Supervisors of Office and Administrative Support Workers
44,Rhode Island,432,418,381,37,37,0,0,21,19,2,2,0,0,43-2000,Communications Equipment Operators
44,Rhode Island,433,7346,6742,604,40,55,0,458,420,38,2,3,0,43-3000,Financial Clerks
44,Rhode Island,434,18178,16186,1992,327,291,15,1008,906,102,8,15,1,43-4000,Information and Record Clerks
44,Rhode Island,435,8412,7014,1398,82,104,0,463,407,56,4,10,0,43-5000,"Material Recording, Scheduling, Dispatching, and Distributing Workers"
44,Rhode Island,436,12460,11059,1401,178,166,22,721,642,79,6,12,2,43-6000,Secretaries and Administrative Assistants
44,Rhode Island,439,9364,8344,1020,146,184,0,605,545,60,6,10,0,43-9000,Other Office and Administrative Support Workers
44,Rhode Island,451,64,64,0,0,0,0,1,1,0,0,0,0,45-1000,"Supervisors of Farming, Fishing, and Forestry Workers"
44,Rhode Island,452,501,426,75,0,0,43,42,38,4,1,0,1,45-2000,Agricultural Workers
44,Rhode Island,453,755,650,105,0,23,0,35,31,4,0,1,0,45-3000,Fishing and Hunting Workers
44,Rhode Island,454,14,14,0,0,0,0,3,3,0,0,0,0,45-4000,"Forest, Conservation, and Logging Workers"
44,Rhode Island,471,1720,1573,147,52,0,0,82,76,6,2,0,0,47-1000,Supervisors of Construction and Extraction Workers
44,Rhode Island,472,19787,16492,3295,849,502,217,1016,879,137,28,21,9,47-2000,Construction Trades Workers
44,Rhode Island,473,87,87,0,0,0,0,6,5,1,0,0,0,47-3000,"Helpers, Construction Trades"
44,Rhode Island,474,882,753,129,15,0,22,44,38,6,1,0,1,47-4000,Other Construction and Related Workers
44,Rhode Island,475,30,30,0,0,0,0,4,4,0,0,0,0,47-5000,Extraction Workers
44,Rhode Island,491,480,466,14,0,0,0,29,28,1,0,0,0,49-1000,"Supervisors of Installation, Maintenance, and Repair Workers"
44,Rhode Island,492,1747,1406,341,36,0,0,81,70,11,2,0,0,49-2000,"Electrical and Electronic Equipment Mechanics, Installers, and Repairers"
44,Rhode Island,493,4486,3805,681,205,36,23,232,204,28,9,1,2,49-3000,"Vehicle and Mobile Equipment Mechanics, Installers, and Repairers"
44,Rhode Island,499,5464,4606,858,172,59,8,301,261,40,4,2,1,49-9000,"Other Installation, Maintenance, and Repair Occupations"
44,Rhode Island,511,2755,1854,901,134,137,0,140,101,39,5,5,0,51-1000,Supervisors of Production Workers
44,Rhode Island,512,3054,1792,1262,223,218,38,160,96,64,10,10,3,51-2000,Assemblers and Fabricators
44,Rhode Island,513,1770,1150,620,174,0,14,102,79,23,6,0,1,51-3000,Food Processing Workers
44,Rhode Island,514,6715,4200,2515,646,166,34,337,236,101,18,6,2,51-4000,Metal Workers and Plastic Workers
44,Rhode Island,5151,750,561,189,13,0,0,30,22,8,1,0,0,51-5100,Printing Workers
44,Rhode Island,516,1988,848,1140,26,319,55,113,58,55,3,11,4,51-6000,"Textile, Apparel, and Furnishings Workers"
44,Rhode Island,517,391,345,46,0,10,0,23,19,4,0,2,0,51-7000,Woodworkers
44,Rhode Island,518,675,619,56,0,0,0,38,36,2,0,0,0,51-8000,Plant and System Operators
44,Rhode Island,519,11192,6483,4709,1177,512,104,551,351,200,34,23,8,51-9000,Other Production Occupations
44,Rhode Island,531,344,328,16,0,16,0,23,22,1,0,1,0,53-1000,Supervisors of Transportation and Material Moving Workers
44,Rhode Island,532,579,579,0,0,0,0,28,27,1,0,0,0,53-2000,Air Transportation Workers
44,Rhode Island,533,13293,9894,3399,1030,345,78,665,539,126,29,11,3,53-3000,Motor Vehicle Operators
44,Rhode Island,534,78,72,6,0,0,0,7,6,1,0,0,0,53-4000,Rail Transportation Workers
44,Rhode Island,535,360,320,40,0,0,0,31,27,4,0,0,0,53-5000,Water Transportation Workers
44,Rhode Island,536,904,750,154,85,0,19,59,54,5,1,0,1,53-6000,Other Transportation Workers
44,Rhode Island,537,15516,11717,3799,1007,202,164,869,713,156,32,15,4,53-7000,Material Moving Workers
45,South Carolina,111,26293,25175,1118,35,108,58,1516,1452,64,1,3,2,11-1000,Top Executives
45,South Carolina,112,12817,12322,495,0,22,12,762,734,28,0,2,2,11-2000,"Advertising, Marketing, Promotions, Public Relations, and Sales Managers"
45,South Carolina,113,41732,38700,3032,215,282,200,2396,2250,146,6,14,9,11-3000,Operations Specialties Managers
45,South Carolina,119,118876,110447,8429,233,865,1839,6393,6026,367,10,36,59,11-9000,Other Management Occupations
45,South Carolina,131,56698,53522,3176,154,414,238,3147,2981,166,6,16,11,13-1000,Business Operations Specialists
45,South Carolina,132,36375,34583,1792,138,202,40,2110,2008,102,6,10,6,13-2000,Financial Specialists
45,South Carolina,1512,42803,38757,4046,108,49,233,2346,2146,200,3,5,11,15-1200,Computer Occupations
45,South Carolina,152,1849,1727,122,0,0,0,127,120,7,0,0,0,15-2000,Mathematical Science Occupations
45,South Carolina,171,2402,2259,143,16,0,0,135,128,7,1,0,0,17-1000,"Architects, Surveyors, and Cartographers"
45,South Carolina,172,28876,25813,3063,0,96,171,1589,1426,163,0,5,11,17-2000,Engineers
45,South Carolina,173,10404,9967,437,0,73,43,602,577,25,0,2,3,17-3000,"Drafters, Engineering Technicians, and Mapping Technicians"
45,South Carolina,191,2068,1744,324,38,28,0,132,114,18,1,1,0,19-1000,Life Scientists
45,South Carolina,192,3471,2805,666,0,23,13,203,165,38,0,2,1,19-2000,Physical Scientists
45,South Carolina,193,2235,2204,31,20,0,0,146,140,6,1,0,0,19-3000,Social Scientists and Related Workers
45,South Carolina,194,5346,5246,100,0,0,0,336,329,7,0,0,0,19-4000,"Life, Physical, and Social Science Technicians"
45,South Carolina,195,1151,1016,135,0,87,0,56,53,3,0,1,0,19-5000,Occupational Health and Safety Specialists and Technicians
45,South Carolina,211,25737,25298,439,75,39,26,1431,1399,32,2,6,1,21-1000,"Counselors, Social Workers, and Other Community and Social Service Specialists"
45,South Carolina,212,11829,11014,815,176,135,55,677,649,28,3,6,4,21-2000,Religious Workers
45,South Carolina,231,8479,8331,148,0,12,0,547,536,11,0,1,0,23-1000,"Lawyers, Judges, and Related Workers"
45,South Carolina,232,8088,7682,406,14,166,0,467,451,16,2,4,0,23-2000,Legal Support Workers
45,South Carolina,251,17257,14225,3032,51,219,32,1076,905,171,2,13,1,25-1000,Postsecondary Teachers
45,South Carolina,252,78640,75811,2829,75,274,102,4758,4584,174,8,20,6,25-2000,"Preschool, Elementary, Middle, Secondary, and Special Education Teachers"
45,South Carolina,253,10767,10161,606,0,75,0,730,680,50,0,6,0,25-3000,Other Teachers and Instructors
45,South Carolina,254,3646,3562,84,0,0,0,239,235,4,0,0,0,25-4000,"Librarians, Curators, and Archivists"
45,South Carolina,259,13119,12200,919,44,52,228,897,849,48,4,4,9,25-9000,Other Educational Instruction and Library Occupations
45,South Carolina,271,10738,10224,514,0,39,47,657,628,29,0,2,3,27-1000,Art and Design Workers
45,South Carolina,272,8270,7939,331,28,8,31,588,562,26,1,1,3,27-2000,"Entertainers and Performers, Sports and Related Workers"
45,South Carolina,273,7606,6996,610,26,153,121,496,451,45,4,10,9,27-3000,Media and Communication Workers
45,South Carolina,274,3470,3261,209,103,0,0,216,208,8,1,0,0,27-4000,Media and Communication Equipment Workers
45,South Carolina,291,88785,83231,5554,97,326,168,5009,4732,277,6,16,4,29-1000,Healthcare Diagnosing or Treating Practitioners
45,South Carolina,292,44965,43289,1676,0,214,155,2326,2241,85,0,9,6,29-2000,Health Technologists and Technicians
45,South Carolina,299,1003,935,68,0,0,0,63,61,2,0,0,0,29-9000,Other Healthcare Practitioners and Technical Occupations
45,South Carolina,3111,39062,37591,1471,43,85,196,2088,2013,75,3,7,7,31-1100,"Home Health and Personal Care Aides; and Nursing Assistants, Orderlies, and Psychiatric Aides"
45,South Carolina,312,1572,1534,38,0,0,0,92,88,4,0,0,0,31-2000,Occupational Therapy and Physical Therapist Assistants and Aides
45,South Carolina,319,18220,17672,548,63,29,131,990,957,33,4,4,6,31-9000,Other Healthcare Support Occupations
45,South Carolina,331,5064,4970,94,0,0,0,288,282,6,0,0,0,33-1000,Supervisors of Protective Service Workers
45,South Carolina,332,5120,5082,38,0,0,0,262,259,3,0,0,0,33-2000,Firefighting and Prevention Workers
45,South Carolina,333,18709,18286,423,0,127,12,988,968,20,0,4,1,33-3000,Law Enforcement Workers
45,South Carolina,339,16271,15744,527,22,51,121,1050,1020,30,1,3,2,33-9000,Other Protective Service Workers
45,South Carolina,351,15118,14018,1100,31,21,340,741,685,56,2,1,12,35-1000,Supervisors of Food Preparation and Serving Workers
45,South Carolina,352,52448,46791,5657,814,390,1847,2908,2693,215,27,15,65,35-2000,Cooks and Food Preparation Workers
45,South Carolina,353,54368,50569,3799,204,451,1384,3136,2962,174,7,23,49,35-3000,Food and Beverage Serving Workers
45,South Carolina,359,13117,12390,727,214,15,165,1000,950,50,8,4,13,35-9000,Other Food Preparation and Serving Related Workers
45,South Carolina,371,6513,6033,480,8,40,275,342,324,18,1,2,6,37-1000,Supervisors of Building and Grounds Cleaning and Maintenance Workers
45,South Carolina,372,61726,52096,9630,1865,1384,4286,3390,2975,415,77,57,168,37-2000,Building Cleaning and Pest Control Workers
45,South Carolina,373,23936,19625,4311,1083,95,2712,1281,1139,142,30,4,89,37-3000,Grounds Maintenance Workers
45,South Carolina,391,1341,1186,155,0,0,0,53,46,7,0,0,0,39-1000,Supervisors of Personal Care and Service Workers
45,South Carolina,392,4780,4551,229,0,44,73,277,268,9,0,2,1,39-2000,Animal Care and Service Workers
45,South Carolina,393,3712,3666,46,0,0,0,296,292,4,0,0,0,39-3000,Entertainment Attendants and Related Workers
45,South Carolina,394,802,802,0,0,0,0,40,40,0,0,0,0,39-4000,Funeral Service Workers
45,South Carolina,395,20949,17941,3008,12,45,139,947,838,109,2,1,5,39-5000,Personal Appearance Workers
45,South Carolina,396,526,473,53,22,31,0,33,30,3,1,1,0,39-6000,"Baggage Porters, Bellhops, and Concierges"
45,South Carolina,397,822,822,0,0,0,0,54,53,1,0,0,0,39-7000,Tour and Travel Guides
45,South Carolina,399,22893,21649,1244,128,211,230,1819,1750,69,6,13,7,39-9000,Other Personal Care and Service Workers
45,South Carolina,411,65338,61737,3601,221,259,227,3545,3384,161,9,13,11,41-1000,Supervisors of Sales Workers
45,South Carolina,412,106202,101812,4390,135,362,897,6714,6438,276,14,28,44,41-2000,Retail Sales Workers
45,South Carolina,413,20320,19718,602,57,142,69,1096,1070,26,1,2,3,41-3000,"Sales Representatives, Services"
45,South Carolina,414,18339,17698,641,15,46,48,1068,1029,39,1,3,2,41-4000,"Sales Representatives, Wholesale and Manufacturing"
45,South Carolina,419,18934,18273,661,0,89,139,1129,1083,46,0,6,4,41-9000,Other Sales and Related Workers
45,South Carolina,431,18177,17726,451,62,79,90,985,952,33,8,6,5,43-1000,Supervisors of Office and Administrative Support Workers
45,South Carolina,432,1027,999,28,0,0,12,68,66,2,0,0,1,43-2000,Communications Equipment Operators
45,South Carolina,433,31961,31228,733,59,29,56,1900,1849,51,2,5,5,43-3000,Financial Clerks
45,South Carolina,434,77006,74275,2731,224,315,331,4255,4089,166,8,27,21,43-4000,Information and Record Clerks
45,South Carolina,435,33425,32495,930,56,53,89,1839,1774,65,4,7,8,43-5000,"Material Recording, Scheduling, Dispatching, and Distributing Workers"
45,South Carolina,436,40821,39801,1020,54,235,189,2671,2613,58,6,6,8,43-6000,Secretaries and Administrative Assistants
45,South Carolina,439,35674,34593,1081,65,263,131,2285,2219,66,3,13,6,43-9000,Other Office and Administrative Support Workers
45,South Carolina,451,656,427,229,77,0,152,35,30,5,2,0,3,45-1000,"Supervisors of Farming, Fishing, and Forestry Workers"
45,South Carolina,452,6574,4100,2474,475,54,1691,402,266,136,10,4,110,45-2000,Agricultural Workers
45,South Carolina,453,424,424,0,0,0,0,27,27,0,0,0,0,45-3000,Fishing and Hunting Workers
45,South Carolina,454,1769,1567,202,0,0,202,87,82,5,0,0,5,45-4000,"Forest, Conservation, and Logging Workers"
45,South Carolina,471,11661,10989,672,190,78,319,637,610,27,6,3,13,47-1000,Supervisors of Construction and Extraction Workers
45,South Carolina,472,88894,68419,20475,4853,1125,13342,4424,3771,653,145,38,403,47-2000,Construction Trades Workers
45,South Carolina,473,1092,897,195,21,0,174,68,60,8,1,0,6,47-3000,"Helpers, Construction Trades"
45,South Carolina,474,4458,4161,297,33,0,167,249,238,11,1,0,7,47-4000,Other Construction and Related Workers
45,South Carolina,475,1076,1062,14,0,0,0,58,57,1,0,0,0,47-5000,Extraction Workers
45,South Carolina,491,4834,4586,248,7,78,96,276,267,9,1,2,2,49-1000,"Supervisors of Installation, Maintenance, and Repair Workers"
45,South Carolina,492,7892,7653,239,0,52,7,423,406,17,0,2,1,49-2000,"Electrical and Electronic Equipment Mechanics, Installers, and Repairers"
45,South Carolina,493,27392,26363,1029,273,154,227,1407,1356,51,9,6,12,49-3000,"Vehicle and Mobile Equipment Mechanics, Installers, and Repairers"
45,South Carolina,499,40148,37730,2418,207,420,1155,2273,2175,98,7,13,39,49-9000,"Other Installation, Maintenance, and Repair Occupations"
45,South Carolina,511,19132,18091,1041,86,63,577,1037,984,53,4,4,24,51-1000,Supervisors of Production Workers
45,South Carolina,512,31316,29300,2016,232,382,398,1540,1434,106,10,17,21,51-2000,Assemblers and Fabricators
45,South Carolina,513,9389,8497,892,144,48,243,507,463,44,5,3,13,51-3000,Food Processing Workers
45,South Carolina,514,32986,30918,2068,252,260,734,1691,1601,90,8,10,30,51-4000,Metal Workers and Plastic Workers
45,South Carolina,5151,3098,2995,103,0,0,43,158,153,5,0,0,1,51-5100,Printing Workers
45,South Carolina,516,12300,10578,1722,94,8,1006,669,597,72,6,1,35,51-6000,"Textile, Apparel, and Furnishings Workers"
45,South Carolina,517,1547,1382,165,28,68,18,103,95,8,1,2,1,51-7000,Woodworkers
45,South Carolina,518,5016,4732,284,69,38,85,285,276,9,2,2,1,51-8000,Plant and System Operators
45,South Carolina,519,71598,66541,5057,538,709,1862,3677,3466,211,17,31,78,51-9000,Other Production Occupations
45,South Carolina,531,3619,3551,68,0,28,0,183,177,6,0,1,1,53-1000,Supervisors of Transportation and Material Moving Workers
45,South Carolina,532,3114,2900,214,13,122,0,177,168,9,1,3,0,53-2000,Air Transportation Workers
45,South Carolina,533,59810,57483,2327,181,121,302,3198,3088,110,7,8,11,53-3000,Motor Vehicle Operators
45,South Carolina,534,1006,995,11,0,0,11,55,53,2,0,0,1,53-4000,Rail Transportation Workers
45,South Carolina,535,660,565,95,0,0,0,47,45,2,0,0,0,53-5000,Water Transportation Workers
45,South Carolina,536,2497,2356,141,0,29,62,162,155,7,0,2,2,53-6000,Other Transportation Workers
45,South Carolina,537,89210,84722,4488,839,328,1835,4931,4716,215,31,21,70,53-7000,Material Moving Workers
46,South Dakota,111,4937,4907,30,0,0,0,231,230,1,0,0,0,11-1000,Top Executives
46,South Dakota,112,2243,2216,27,0,0,27,89,88,1,0,0,1,11-2000,"Advertising, Marketing, Promotions, Public Relations, and Sales Managers"
46,South Dakota,113,8901,8734,167,11,0,30,438,428,10,1,0,2,11-3000,Operations Specialties Managers
46,South Dakota,119,32535,31941,594,158,63,13,2015,1988,27,6,1,2,11-9000,Other Management Occupations
46,South Dakota,131,9015,8685,330,0,59,22,413,404,9,0,1,1,13-1000,Business Operations Specialists
46,South Dakota,132,7657,7465,192,47,0,0,398,388,10,2,0,0,13-2000,Financial Specialists
46,South Dakota,1512,7389,7208,181,0,0,0,334,325,9,0,0,0,15-1200,Computer Occupations
46,South Dakota,152,241,241,0,0,0,0,9,9,0,0,0,0,15-2000,Mathematical Science Occupations
46,South Dakota,171,326,326,0,0,0,0,17,17,0,0,0,0,17-1000,"Architects, Surveyors, and Cartographers"
46,South Dakota,172,3867,3562,305,0,0,0,160,155,5,0,0,0,17-2000,Engineers
46,South Dakota,173,2280,2280,0,0,0,0,108,107,1,0,0,0,17-3000,"Drafters, Engineering Technicians, and Mapping Technicians"
46,South Dakota,191,1075,1067,8,0,0,8,55,54,1,0,0,1,19-1000,Life Scientists
46,South Dakota,192,262,234,28,0,0,18,16,12,4,0,0,1,19-2000,Physical Scientists
46,South Dakota,193,519,519,0,0,0,0,20,20,0,0,0,0,19-3000,Social Scientists and Related Workers
46,South Dakota,194,979,962,17,0,0,0,66,63,3,0,0,0,19-4000,"Life, Physical, and Social Science Technicians"
46,South Dakota,195,149,149,0,0,0,0,6,6,0,0,0,0,19-5000,Occupational Health and Safety Specialists and Technicians
46,South Dakota,211,5642,5515,127,0,0,0,288,282,6,0,0,1,21-1000,"Counselors, Social Workers, and Other Community and Social Service Specialists"
46,South Dakota,212,2171,2019,152,0,0,16,122,117,5,1,0,1,21-2000,Religious Workers
46,South Dakota,231,1845,1807,38,0,0,0,70,69,1,0,0,0,23-1000,"Lawyers, Judges, and Related Workers"
46,South Dakota,232,1013,1001,12,12,0,0,45,44,1,1,0,0,23-2000,Legal Support Workers
46,South Dakota,251,2949,2455,494,0,0,0,125,107,18,0,0,0,25-1000,Postsecondary Teachers
46,South Dakota,252,14988,14621,367,0,73,0,865,854,11,0,3,0,25-2000,"Preschool, Elementary, Middle, Secondary, and Special Education Teachers"
46,South Dakota,253,1537,1474,63,0,0,0,80,75,5,0,0,1,25-3000,Other Teachers and Instructors
46,South Dakota,254,487,480,7,0,0,0,37,36,1,0,0,0,25-4000,"Librarians, Curators, and Archivists"
46,South Dakota,259,3727,3437,290,0,116,0,242,235,7,0,1,0,25-9000,Other Educational Instruction and Library Occupations
46,South Dakota,271,2675,2588,87,0,14,0,105,101,4,1,1,0,27-1000,Art and Design Workers
46,South Dakota,272,1075,1075,0,0,0,0,77,77,0,0,0,0,27-2000,"Entertainers and Performers, Sports and Related Workers"
46,South Dakota,273,1596,1521,75,0,0,0,91,89,2,0,0,0,27-3000,Media and Communication Workers
46,South Dakota,274,646,646,0,0,0,0,28,28,0,0,0,0,27-4000,Media and Communication Equipment Workers
46,South Dakota,291,19563,18916,647,0,23,0,961,934,27,0,1,1,29-1000,Healthcare Diagnosing or Treating Practitioners
46,South Dakota,292,8426,8039,387,0,0,0,407,397,10,1,0,0,29-2000,Health Technologists and Technicians
46,South Dakota,299,217,217,0,0,0,0,12,12,0,0,0,0,29-9000,Other Healthcare Practitioners and Technical Occupations
46,South Dakota,3111,8328,7744,584,0,4,47,517,498,19,0,2,3,31-1100,"Home Health and Personal Care Aides; and Nursing Assistants, Orderlies, and Psychiatric Aides"
46,South Dakota,312,451,451,0,0,0,0,21,20,1,0,0,0,31-2000,Occupational Therapy and Physical Therapist Assistants and Aides
46,South Dakota,319,3225,2969,256,0,0,6,181,173,8,0,0,1,31-9000,Other Healthcare Support Occupations
46,South Dakota,331,541,541,0,0,0,0,22,22,0,0,0,0,33-1000,Supervisors of Protective Service Workers
46,South Dakota,332,680,634,46,0,0,0,33,30,3,0,0,0,33-2000,Firefighting and Prevention Workers
46,South Dakota,333,2983,2947,36,0,0,0,166,164,2,0,0,0,33-3000,Law Enforcement Workers
46,South Dakota,339,2938,2831,107,0,0,0,217,213,4,0,0,0,33-9000,Other Protective Service Workers
46,South Dakota,351,2639,2437,202,0,0,72,115,110,5,0,0,1,35-1000,Supervisors of Food Preparation and Serving Workers
46,South Dakota,352,8825,8437,388,10,0,49,588,566,22,1,0,6,35-2000,Cooks and Food Preparation Workers
46,South Dakota,353,9263,8924,339,88,0,75,500,489,11,3,0,1,35-3000,Food and Beverage Serving Workers
46,South Dakota,359,2783,2530,253,0,0,16,172,163,9,0,0,1,35-9000,Other Food Preparation and Serving Related Workers
46,South Dakota,371,1173,1162,11,0,0,0,57,56,1,0,0,0,37-1000,Supervisors of Building and Grounds Cleaning and Maintenance Workers
46,South Dakota,372,10306,9116,1190,127,0,24,660,618,42,7,0,5,37-2000,Building Cleaning and Pest Control Workers
46,South Dakota,373,2692,2578,114,0,0,99,223,217,6,0,0,2,37-3000,Grounds Maintenance Workers
46,South Dakota,391,349,349,0,0,0,0,18,18,0,0,0,0,39-1000,Supervisors of Personal Care and Service Workers
46,South Dakota,392,589,570,19,0,19,0,44,43,1,0,1,0,39-2000,Animal Care and Service Workers
46,South Dakota,393,614,608,6,0,0,0,58,57,1,0,0,0,39-3000,Entertainment Attendants and Related Workers
46,South Dakota,394,242,191,51,0,0,0,11,10,1,0,0,0,39-4000,Funeral Service Workers
46,South Dakota,395,2497,2303,194,0,0,0,117,111,6,0,0,0,39-5000,Personal Appearance Workers
46,South Dakota,396,97,97,0,0,0,0,6,6,0,0,0,0,39-6000,"Baggage Porters, Bellhops, and Concierges"
46,South Dakota,397,204,204,0,0,0,0,23,23,0,0,0,0,39-7000,Tour and Travel Guides
46,South Dakota,399,7784,7523,261,0,0,0,457,449,8,0,0,0,39-9000,Other Personal Care and Service Workers
46,South Dakota,411,11665,11474,191,0,0,44,607,596,11,0,0,3,41-1000,Supervisors of Sales Workers
46,South Dakota,412,16710,15934,776,226,10,7,1007,973,34,5,2,1,41-2000,Retail Sales Workers
46,South Dakota,413,4545,4545,0,0,0,0,195,192,3,0,0,0,41-3000,"Sales Representatives, Services"
46,South Dakota,414,3998,3974,24,0,0,0,186,184,2,0,0,0,41-4000,"Sales Representatives, Wholesale and Manufacturing"
46,South Dakota,419,2584,2584,0,0,0,0,121,119,2,1,0,0,41-9000,Other Sales and Related Workers
46,South Dakota,431,2547,2508,39,0,0,0,143,140,3,0,0,0,43-1000,Supervisors of Office and Administrative Support Workers
46,South Dakota,432,206,206,0,0,0,0,12,12,0,0,0,0,43-2000,Communications Equipment Operators
46,South Dakota,433,10532,10420,112,0,3,25,551,541,10,0,1,2,43-3000,Financial Clerks
46,South Dakota,434,13830,13488,342,33,0,0,716,702,14,2,0,0,43-4000,Information and Record Clerks
46,South Dakota,435,5421,5176,245,24,0,45,308,298,10,2,0,2,43-5000,"Material Recording, Scheduling, Dispatching, and Distributing Workers"
46,South Dakota,436,9837,9754,83,0,0,4,587,581,6,0,0,1,43-6000,Secretaries and Administrative Assistants
46,South Dakota,439,7054,6797,257,0,0,0,400,387,13,0,0,2,43-9000,Other Office and Administrative Support Workers
46,South Dakota,451,227,220,7,1,0,6,17,15,2,1,0,1,45-1000,"Supervisors of Farming, Fishing, and Forestry Workers"
46,South Dakota,452,6634,6087,547,195,0,299,587,551,36,10,0,22,45-2000,Agricultural Workers
46,South Dakota,453,43,43,0,0,0,0,4,4,0,0,0,0,45-3000,Fishing and Hunting Workers
46,South Dakota,454,298,181,117,0,0,117,16,12,4,0,0,4,45-4000,"Forest, Conservation, and Logging Workers"
46,South Dakota,471,2727,2625,102,0,0,102,143,142,1,0,0,1,47-1000,Supervisors of Construction and Extraction Workers
46,South Dakota,472,19741,18573,1168,639,0,164,1078,1047,31,10,0,4,47-2000,Construction Trades Workers
46,South Dakota,473,118,118,0,0,0,0,4,4,0,0,0,0,47-3000,"Helpers, Construction Trades"
46,South Dakota,474,1118,1118,0,0,0,0,91,91,0,0,0,0,47-4000,Other Construction and Related Workers
46,South Dakota,475,654,638,16,0,0,16,34,33,1,0,0,1,47-5000,Extraction Workers
46,South Dakota,491,849,849,0,0,0,0,44,44,0,0,0,0,49-1000,"Supervisors of Installation, Maintenance, and Repair Workers"
46,South Dakota,492,927,890,37,0,0,0,58,55,3,0,0,0,49-2000,"Electrical and Electronic Equipment Mechanics, Installers, and Repairers"
46,South Dakota,493,5771,5637,134,0,0,94,345,340,5,0,0,3,49-3000,"Vehicle and Mobile Equipment Mechanics, Installers, and Repairers"
46,South Dakota,499,6210,5877,333,59,0,48,364,354,10,2,0,4,49-9000,"Other Installation, Maintenance, and Repair Occupations"
46,South Dakota,511,2366,2231,135,0,0,0,141,136,5,0,0,0,51-1000,Supervisors of Production Workers
46,South Dakota,512,3742,3254,488,3,0,48,207,192,15,1,0,2,51-2000,Assemblers and Fabricators
46,South Dakota,513,4047,2064,1983,138,0,67,161,120,41,2,0,2,51-3000,Food Processing Workers
46,South Dakota,514,6600,6454,146,0,4,46,329,321,8,0,1,1,51-4000,Metal Workers and Plastic Workers
46,South Dakota,5151,802,755,47,0,0,0,40,39,1,0,0,0,51-5100,Printing Workers
46,South Dakota,516,877,794,83,0,0,0,64,61,3,0,0,0,51-6000,"Textile, Apparel, and Furnishings Workers"
46,South Dakota,517,674,674,0,0,0,0,41,41,0,0,0,0,51-7000,Woodworkers
46,South Dakota,518,727,727,0,0,0,0,47,47,0,0,0,0,51-8000,Plant and System Operators
46,South Dakota,519,9708,7315,2393,115,0,374,480,422,58,5,0,12,51-9000,Other Production Occupations
46,South Dakota,531,626,626,0,0,0,0,38,38,0,0,0,0,53-1000,Supervisors of Transportation and Material Moving Workers
46,South Dakota,532,847,847,0,0,0,0,26,26,0,0,0,0,53-2000,Air Transportation Workers
46,South Dakota,533,12212,11790,422,43,4,14,754,742,12,2,1,1,53-3000,Motor Vehicle Operators
46,South Dakota,534,737,637,100,4,0,0,37,35,2,1,0,0,53-4000,Rail Transportation Workers
46,South Dakota,536,633,565,68,0,0,0,36,35,1,0,0,0,53-6000,Other Transportation Workers
46,South Dakota,537,12250,11468,782,125,0,123,736,705,31,7,0,6,53-7000,Material Moving Workers
47,Tennessee,111,38742,37000,1742,26,232,178,2202,2113,89,2,9,4,11-1000,Top Executives
47,Tennessee,112,20449,19756,693,0,0,49,1093,1050,43,0,0,4,11-2000,"Advertising, Marketing, Promotions, Public Relations, and Sales Managers"
47,Tennessee,113,54799,51910,2889,90,288,138,3051,2918,133,5,12,10,11-3000,Operations Specialties Managers
47,Tennessee,119,156179,147336,8843,444,459,1851,8773,8339,434,20,23,80,11-9000,Other Management Occupations
47,Tennessee,131,78838,75439,3399,168,311,335,4405,4217,188,8,15,14,13-1000,Business Operations Specialists
47,Tennessee,132,55284,52810,2474,107,95,159,3079,2935,144,9,9,11,13-2000,Financial Specialists
47,Tennessee,1512,64667,57146,7521,180,149,324,3459,3123,336,9,12,12,15-1200,Computer Occupations
47,Tennessee,152,3015,2732,283,0,16,7,175,161,14,0,1,1,15-2000,Mathematical Science Occupations
47,Tennessee,171,2563,2417,146,0,42,0,158,151,7,0,1,0,17-1000,"Architects, Surveyors, and Cartographers"
47,Tennessee,172,30059,26878,3181,67,184,481,1744,1588,156,4,10,17,17-2000,Engineers
47,Tennessee,173,13276,12652,624,0,19,191,720,693,27,0,1,6,17-3000,"Drafters, Engineering Technicians, and Mapping Technicians"
47,Tennessee,191,3904,2729,1175,0,24,21,228,165,63,0,2,1,19-1000,Life Scientists
47,Tennessee,192,6229,4455,1774,0,66,5,358,271,87,0,5,1,19-2000,Physical Scientists
47,Tennessee,193,3282,3070,212,0,19,0,178,171,7,0,2,0,19-3000,Social Scientists and Related Workers
47,Tennessee,194,7722,6658,1064,21,0,75,465,420,45,1,0,2,19-4000,"Life, Physical, and Social Science Technicians"
47,Tennessee,195,1642,1625,17,0,0,0,84,83,1,0,0,0,19-5000,Occupational Health and Safety Specialists and Technicians
47,Tennessee,211,32581,31661,920,75,63,36,1766,1711,55,3,3,4,21-1000,"Counselors, Social Workers, and Other Community and Social Service Specialists"
47,Tennessee,212,14480,13571,909,172,34,175,892,851,41,6,3,9,21-2000,Religious Workers
47,Tennessee,231,14546,14290,256,14,0,0,869,851,18,1,0,0,23-1000,"Lawyers, Judges, and Related Workers"
47,Tennessee,232,8484,8205,279,16,0,21,498,485,13,1,0,2,23-2000,Legal Support Workers
47,Tennessee,251,23989,19898,4091,96,167,58,1467,1227,240,4,12,4,25-1000,Postsecondary Teachers
47,Tennessee,252,103584,101392,2192,98,151,113,6256,6121,135,6,8,9,25-2000,"Preschool, Elementary, Middle, Secondary, and Special Education Teachers"
47,Tennessee,253,15176,14044,1132,30,55,42,988,920,68,3,2,4,25-3000,Other Teachers and Instructors
47,Tennessee,254,4236,4107,129,0,0,0,268,257,11,0,0,2,25-4000,"Librarians, Curators, and Archivists"
47,Tennessee,259,22226,21153,1073,63,85,74,1442,1380,62,4,4,4,25-9000,Other Educational Instruction and Library Occupations
47,Tennessee,271,16893,16205,688,74,81,21,999,959,40,2,5,3,27-1000,Art and Design Workers
47,Tennessee,272,18625,18091,534,14,83,31,1132,1096,36,3,3,1,27-2000,"Entertainers and Performers, Sports and Related Workers"
47,Tennessee,273,12671,11538,1133,0,68,325,761,696,65,0,6,9,27-3000,Media and Communication Workers
47,Tennessee,274,7683,7541,142,34,0,0,477,465,12,2,0,0,27-4000,Media and Communication Equipment Workers
47,Tennessee,291,124608,116286,8322,208,361,371,7148,6731,417,10,24,16,29-1000,Healthcare Diagnosing or Treating Practitioners
47,Tennessee,292,67109,64362,2747,93,87,217,3809,3679,130,7,4,9,29-2000,Health Technologists and Technicians
47,Tennessee,299,1796,1749,47,0,11,36,107,103,4,0,1,1,29-9000,Other Healthcare Practitioners and Technical Occupations
47,Tennessee,3111,53617,50807,2810,35,60,265,2987,2875,112,6,4,11,31-1100,"Home Health and Personal Care Aides; and Nursing Assistants, Orderlies, and Psychiatric Aides"
47,Tennessee,312,4053,3822,231,0,0,0,220,214,6,0,0,0,31-2000,Occupational Therapy and Physical Therapist Assistants and Aides
47,Tennessee,319,24949,24073,876,53,119,200,1370,1317,53,3,5,10,31-9000,Other Healthcare Support Occupations
47,Tennessee,331,5794,5716,78,0,0,0,353,348,5,0,0,0,33-1000,Supervisors of Protective Service Workers
47,Tennessee,332,6362,6266,96,0,0,0,341,336,5,0,0,0,33-2000,Firefighting and Prevention Workers
47,Tennessee,333,26866,26557,309,52,49,10,1362,1345,17,1,3,1,33-3000,Law Enforcement Workers
47,Tennessee,339,22728,21628,1100,4,30,57,1342,1291,51,1,2,3,33-9000,Other Protective Service Workers
47,Tennessee,351,19117,16988,2129,138,124,443,915,837,78,7,6,14,35-1000,Supervisors of Food Preparation and Serving Workers
47,Tennessee,352,69512,60312,9200,1664,350,5145,4115,3741,374,54,20,177,35-2000,Cooks and Food Preparation Workers
47,Tennessee,353,71843,66508,5335,335,102,2138,4096,3823,273,22,8,79,35-3000,Food and Beverage Serving Workers
47,Tennessee,359,17343,15022,2321,563,49,835,1138,1045,93,19,2,35,35-9000,Other Food Preparation and Serving Related Workers
47,Tennessee,371,7130,6333,797,159,106,296,373,334,39,10,4,14,37-1000,Supervisors of Building and Grounds Cleaning and Maintenance Workers
47,Tennessee,372,74659,63491,11168,2789,158,4964,4367,3868,499,108,20,202,37-2000,Building Cleaning and Pest Control Workers
47,Tennessee,373,26234,20772,5462,939,73,4302,1567,1375,192,32,3,138,37-3000,Grounds Maintenance Workers
47,Tennessee,391,1860,1685,175,0,0,0,79,75,4,0,0,0,39-1000,Supervisors of Personal Care and Service Workers
47,Tennessee,392,6020,5888,132,21,0,16,368,358,10,1,1,2,39-2000,Animal Care and Service Workers
47,Tennessee,393,3012,2872,140,5,45,0,249,225,24,1,15,0,39-3000,Entertainment Attendants and Related Workers
47,Tennessee,394,1039,1026,13,0,0,0,70,69,1,0,0,0,39-4000,Funeral Service Workers
47,Tennessee,395,24682,20940,3742,123,104,108,1224,1047,177,8,7,9,39-5000,Personal Appearance Workers
47,Tennessee,396,636,546,90,18,0,0,36,33,3,1,0,0,39-6000,"Baggage Porters, Bellhops, and Concierges"
47,Tennessee,397,1200,1185,15,0,0,0,72,69,3,0,0,0,39-7000,Tour and Travel Guides
47,Tennessee,399,31170,29748,1422,158,119,373,2261,2170,91,9,6,20,39-9000,Other Personal Care and Service Workers
47,Tennessee,411,85840,80422,5418,175,335,340,4509,4297,212,9,10,21,41-1000,Supervisors of Sales Workers
47,Tennessee,412,134315,127213,7102,542,181,1032,8445,8076,369,24,20,52,41-2000,Retail Sales Workers
47,Tennessee,413,27789,27148,641,28,123,14,1539,1505,34,2,4,2,41-3000,"Sales Representatives, Services"
47,Tennessee,414,24649,23781,868,52,66,143,1324,1276,48,2,3,7,41-4000,"Sales Representatives, Wholesale and Manufacturing"
47,Tennessee,419,22892,21882,1010,63,28,86,1352,1298,54,3,2,5,41-9000,Other Sales and Related Workers
47,Tennessee,431,25478,24314,1164,20,300,257,1408,1354,54,1,12,13,43-1000,Supervisors of Office and Administrative Support Workers
47,Tennessee,432,1905,1883,22,0,12,10,112,110,2,0,1,1,43-2000,Communications Equipment Operators
47,Tennessee,433,49670,47955,1715,26,53,284,2919,2841,78,1,3,14,43-3000,Financial Clerks
47,Tennessee,434,107456,103619,3837,198,273,525,6075,5866,209,12,12,37,43-4000,Information and Record Clerks
47,Tennessee,435,48253,46116,2137,227,44,203,2596,2508,88,13,2,13,43-5000,"Material Recording, Scheduling, Dispatching, and Distributing Workers"
47,Tennessee,436,51189,49885,1304,137,11,160,3347,3272,75,3,4,10,43-6000,Secretaries and Administrative Assistants
47,Tennessee,439,54722,53135,1587,125,183,157,3159,3063,96,6,7,11,43-9000,Other Office and Administrative Support Workers
47,Tennessee,451,714,681,33,0,0,33,42,40,2,0,0,2,45-1000,"Supervisors of Farming, Fishing, and Forestry Workers"
47,Tennessee,452,8696,6016,2680,90,0,2393,637,515,122,5,0,111,45-2000,Agricultural Workers
47,Tennessee,453,52,52,0,0,0,0,6,6,0,0,0,0,45-3000,Fishing and Hunting Workers
47,Tennessee,454,1773,1724,49,16,0,20,111,108,3,1,0,1,45-4000,"Forest, Conservation, and Logging Workers"
47,Tennessee,471,14567,13656,911,408,72,276,782,745,37,13,1,15,47-1000,Supervisors of Construction and Extraction Workers
47,Tennessee,472,128105,98836,29269,8237,332,18955,6635,5670,965,264,17,604,47-2000,Construction Trades Workers
47,Tennessee,473,700,604,96,0,0,90,43,35,8,0,0,6,47-3000,"Helpers, Construction Trades"
47,Tennessee,474,5870,5566,304,17,0,215,315,302,13,1,0,7,47-4000,Other Construction and Related Workers
47,Tennessee,475,2343,2191,152,0,0,152,139,136,3,0,0,3,47-5000,Extraction Workers
47,Tennessee,491,6242,5973,269,81,0,98,340,328,12,2,0,5,49-1000,"Supervisors of Installation, Maintenance, and Repair Workers"
47,Tennessee,492,9064,8375,689,28,0,7,476,448,28,2,0,2,49-2000,"Electrical and Electronic Equipment Mechanics, Installers, and Repairers"
47,Tennessee,493,36130,34092,2038,317,82,724,1982,1898,84,14,4,24,49-3000,"Vehicle and Mobile Equipment Mechanics, Installers, and Repairers"
47,Tennessee,499,49540,47142,2398,53,147,789,2738,2649,89,3,6,27,49-9000,"Other Installation, Maintenance, and Repair Occupations"
47,Tennessee,511,25343,24167,1176,242,33,352,1426,1374,52,6,2,16,51-1000,Supervisors of Production Workers
47,Tennessee,512,42298,38567,3731,530,218,1217,2342,2172,170,17,15,48,51-2000,Assemblers and Fabricators
47,Tennessee,513,14095,12649,1446,266,16,413,774,710,64,12,1,14,51-3000,Food Processing Workers
47,Tennessee,514,46428,44273,2155,372,31,767,2628,2523,105,15,4,37,51-4000,Metal Workers and Plastic Workers
47,Tennessee,5151,5392,5091,301,26,0,204,307,298,9,1,1,4,51-5100,Printing Workers
47,Tennessee,516,10697,9047,1650,275,28,541,641,563,78,10,2,24,51-6000,"Textile, Apparel, and Furnishings Workers"
47,Tennessee,517,4116,3774,342,93,21,119,237,215,22,3,2,8,51-7000,Woodworkers
47,Tennessee,518,5670,5535,135,0,0,69,317,313,4,0,0,2,51-8000,Plant and System Operators
47,Tennessee,519,88312,80971,7341,1065,205,2215,4848,4547,301,40,9,90,51-9000,Other Production Occupations
47,Tennessee,531,5985,5593,392,40,139,41,301,280,21,3,5,2,53-1000,Supervisors of Transportation and Material Moving Workers
47,Tennessee,532,5532,5288,244,0,0,0,300,286,14,0,0,0,53-2000,Air Transportation Workers
47,Tennessee,533,92289,87639,4650,440,203,422,4972,4788,184,21,7,17,53-3000,Motor Vehicle Operators
47,Tennessee,534,2126,2126,0,0,0,0,126,126,0,0,0,0,53-4000,Rail Transportation Workers
47,Tennessee,535,1093,1093,0,0,0,0,77,77,0,0,0,0,53-5000,Water Transportation Workers
47,Tennessee,536,4080,3933,147,0,10,0,240,230,10,0,1,0,53-6000,Other Transportation Workers
47,Tennessee,537,146727,135018,11709,1090,420,4385,8020,7563,457,49,18,167,53-7000,Material Moving Workers
48,Texas,111,176914,152770,24144,977,1779,6410,10004,8766,1238,42,85,319,11-1000,Top Executives
48,Texas,112,85210,76244,8966,439,861,1951,4659,4163,496,21,43,106,11-2000,"Advertising, Marketing, Promotions, Public Relations, and Sales Managers"
48,Texas,113,248995,206636,42359,1654,3300,11643,13711,11571,2140,69,153,554,11-3000,Operations Specialties Managers
48,Texas,119,734096,607780,126316,8583,5649,54519,39357,33622,5735,300,274,2247,11-9000,Other Management Occupations
48,Texas,131,383617,329048,54569,2026,3447,15029,20754,18002,2752,95,167,660,13-1000,Business Operations Specialists
48,Texas,132,268471,225177,43294,1765,2156,9366,14874,12632,2242,73,114,477,13-2000,Financial Specialists
48,Texas,1512,366503,260904,105599,1616,2838,8601,19261,14186,5075,74,141,427,15-1200,Computer Occupations
48,Texas,152,17122,13000,4122,140,185,391,916,718,198,5,7,22,15-2000,Mathematical Science Occupations
48,Texas,171,18432,14899,3533,91,261,686,1012,817,195,5,12,28,17-1000,"Architects, Surveyors, and Cartographers"
48,Texas,172,173994,125518,48476,656,4448,5534,9198,6909,2289,23,168,252,17-2000,Engineers
48,Texas,173,59192,49212,9980,432,363,4204,3098,2630,468,15,17,171,17-3000,"Drafters, Engineering Technicians, and Mapping Technicians"
48,Texas,191,13829,8550,5279,22,107,168,825,537,288,1,10,11,19-1000,Life Scientists
48,Texas,192,30633,20290,10343,207,853,464,1746,1189,557,8,46,20,19-2000,Physical Scientists
48,Texas,193,12925,11618,1307,26,102,187,753,683,70,2,9,12,19-3000,Social Scientists and Related Workers
48,Texas,194,29764,25605,4159,99,306,1097,1634,1401,233,6,17,62,19-4000,"Life, Physical, and Social Science Technicians"
48,Texas,195,7804,7056,748,53,0,445,398,359,39,4,0,19,19-5000,Occupational Health and Safety Specialists and Technicians
48,Texas,211,127633,116657,10976,907,586,4974,6860,6273,587,43,36,253,21-1000,"Counselors, Social Workers, and Other Community and Social Service Specialists"
48,Texas,212,46615,39846,6769,537,446,2024,2924,2528,396,23,31,120,21-2000,Religious Workers
48,Texas,231,70651,65636,5015,169,405,594,4183,3877,306,8,30,36,23-1000,"Lawyers, Judges, and Related Workers"
48,Texas,232,41915,38121,3794,295,234,1653,2402,2196,206,17,13,85,23-2000,Legal Support Workers
48,Texas,251,89118,63518,25600,149,1243,2434,5479,4024,1455,11,78,140,25-1000,Postsecondary Teachers
48,Texas,252,502186,452651,49535,2594,4724,21490,29403,26741,2662,129,253,1091,25-2000,"Preschool, Elementary, Middle, Secondary, and Special Education Teachers"
48,Texas,253,66544,55840,10704,445,739,3374,4170,3589,581,25,38,150,25-3000,Other Teachers and Instructors
48,Texas,254,17103,15935,1168,19,11,339,1099,1014,85,1,1,25,25-4000,"Librarians, Curators, and Archivists"
48,Texas,259,98357,81086,17271,747,1282,8367,5982,4999,983,42,53,466,25-9000,Other Educational Instruction and Library Occupations
48,Texas,271,74875,64021,10854,1141,812,3199,4360,3780,580,42,46,163,27-1000,Art and Design Workers
48,Texas,272,48020,42422,5598,214,550,1899,3073,2775,298,7,26,84,27-2000,"Entertainers and Performers, Sports and Related Workers"
48,Texas,273,51213,45366,5847,381,479,2516,3008,2665,343,22,26,109,27-3000,Media and Communication Workers
48,Texas,274,26120,22943,3177,140,207,1207,1489,1341,148,7,10,51,27-4000,Media and Communication Equipment Workers
48,Texas,291,442521,345347,97174,2112,3759,9600,23627,19119,4508,85,183,451,29-1000,Healthcare Diagnosing or Treating Practitioners
48,Texas,292,223808,192207,31601,1476,894,8900,11581,10122,1459,67,52,412,29-2000,Health Technologists and Technicians
48,Texas,299,6994,6258,736,49,13,393,367,331,36,1,2,13,29-9000,Other Healthcare Practitioners and Technical Occupations
48,Texas,3111,248051,189346,58705,3025,1062,33731,13058,10177,2881,156,44,1774,31-1100,"Home Health and Personal Care Aides; and Nursing Assistants, Orderlies, and Psychiatric Aides"
48,Texas,312,8761,7989,772,33,26,317,527,485,42,2,2,18,31-2000,Occupational Therapy and Physical Therapist Assistants and Aides
48,Texas,319,120170,101344,18826,1389,723,9557,5939,5062,877,69,34,412,31-9000,Other Healthcare Support Occupations
48,Texas,331,21911,21098,813,1,27,364,1252,1201,51,1,1,23,33-1000,Supervisors of Protective Service Workers
48,Texas,332,24778,23760,1018,93,156,624,1401,1349,52,6,7,29,33-2000,Firefighting and Prevention Workers
48,Texas,333,122890,111767,11123,443,299,4332,6292,5862,430,14,17,174,33-3000,Law Enforcement Workers
48,Texas,339,100164,89341,10823,541,103,4541,5838,5325,513,32,8,207,33-9000,Other Protective Service Workers
48,Texas,351,79023,58238,20785,1519,552,11843,3692,2812,880,62,30,460,35-1000,Supervisors of Food Preparation and Serving Workers
48,Texas,352,294056,176729,117327,20017,2102,80667,14970,10222,4748,692,81,3272,35-2000,Cooks and Food Preparation Workers
48,Texas,353,287130,232046,55084,6747,2233,33463,15517,13076,2441,233,90,1434,35-3000,Food and Beverage Serving Workers
48,Texas,359,83011,60475,22536,5087,578,14006,4947,3971,976,163,29,616,35-9000,Other Food Preparation and Serving Related Workers
48,Texas,371,28204,18510,9694,1430,227,7202,1376,984,392,58,14,286,37-1000,Supervisors of Building and Grounds Cleaning and Maintenance Workers
48,Texas,372,350090,174096,175994,32459,5251,124054,17806,10227,7579,1262,194,5454,37-2000,Building Cleaning and Pest Control Workers
48,Texas,373,118205,54282,63923,10682,472,52055,5531,3345,2186,332,23,1780,37-3000,Grounds Maintenance Workers
48,Texas,391,8626,6783,1843,123,3,368,377,308,69,3,1,14,39-1000,Supervisors of Personal Care and Service Workers
48,Texas,392,22195,20172,2023,47,54,1315,1390,1281,109,5,7,60,39-2000,Animal Care and Service Workers
48,Texas,393,19181,17861,1320,134,87,515,1210,1122,88,4,7,31,39-3000,Entertainment Attendants and Related Workers
48,Texas,394,3523,3302,221,31,0,161,183,170,13,1,0,9,39-4000,Funeral Service Workers
48,Texas,395,112528,65989,46539,1827,660,10158,5151,3176,1975,70,25,453,39-5000,Personal Appearance Workers
48,Texas,396,4777,3856,921,94,37,316,213,176,37,3,1,13,39-6000,"Baggage Porters, Bellhops, and Concierges"
48,Texas,397,2501,2226,275,0,33,70,204,181,23,0,4,5,39-7000,Tour and Travel Guides
48,Texas,399,143941,116709,27232,3415,2157,14221,8972,7571,1401,150,109,700,39-9000,Other Personal Care and Service Workers
48,Texas,411,367256,305218,62038,4185,2281,26248,18546,15727,2819,179,101,1140,41-1000,Supervisors of Sales Workers
48,Texas,412,607628,501729,105899,8930,3617,51047,34371,29278,5093,379,169,2394,41-2000,Retail Sales Workers
48,Texas,413,145394,128655,16739,1304,1161,5721,7555,6744,811,63,54,272,41-3000,"Sales Representatives, Services"
48,Texas,414,121933,108517,13416,724,1165,6235,6285,5653,632,32,47,279,41-4000,"Sales Representatives, Wholesale and Manufacturing"
48,Texas,419,117898,103371,14527,976,1264,5321,6607,5841,766,50,56,257,41-9000,Other Sales and Related Workers
48,Texas,431,108709,95239,13470,944,791,5702,5863,5220,643,44,36,256,43-1000,Supervisors of Office and Administrative Support Workers
48,Texas,432,8689,7889,800,97,28,386,448,414,34,3,1,17,43-2000,Communications Equipment Operators
48,Texas,433,200676,177322,23354,1444,1138,10802,11217,10041,1176,70,66,518,43-3000,Financial Clerks
48,Texas,434,460240,404517,55723,4442,3049,24853,24214,21507,2707,181,143,1206,43-4000,Information and Record Clerks
48,Texas,435,169404,143125,26279,2787,972,12154,8729,7531,1198,108,42,583,43-5000,"Material Recording, Scheduling, Dispatching, and Distributing Workers"
48,Texas,436,222101,198437,23664,1870,1191,12151,14295,12933,1362,83,68,722,43-6000,Secretaries and Administrative Assistants
48,Texas,439,240032,211719,28313,2224,1129,13768,13818,12263,1555,107,69,721,43-9000,Other Office and Administrative Support Workers
48,Texas,451,3603,2848,755,14,0,679,255,207,48,1,0,43,45-1000,"Supervisors of Farming, Fishing, and Forestry Workers"
48,Texas,452,43438,23514,19924,1392,62,17605,3063,2008,1055,76,4,926,45-2000,Agricultural Workers
48,Texas,453,1787,669,1118,151,0,552,96,50,46,4,0,20,45-3000,Fishing and Hunting Workers
48,Texas,454,2606,2097,509,82,0,427,162,134,28,2,0,26,45-4000,"Forest, Conservation, and Logging Workers"
48,Texas,471,92616,69245,23371,2130,477,18773,4648,3655,993,78,20,813,47-1000,Supervisors of Construction and Extraction Workers
48,Texas,472,726720,350066,376654,61802,3334,299007,30656,17758,12898,1883,115,10360,47-2000,Construction Trades Workers
48,Texas,473,7856,4498,3358,734,6,2239,346,228,118,21,1,88,47-3000,"Helpers, Construction Trades"
48,Texas,474,27333,19817,7516,1026,38,5998,1459,1155,304,38,2,235,47-4000,Other Construction and Related Workers
48,Texas,475,48029,36534,11495,615,101,9201,2404,1907,497,23,7,418,47-5000,Extraction Workers
48,Texas,491,22985,20224,2761,288,102,1652,1313,1172,141,10,7,77,49-1000,"Supervisors of Installation, Maintenance, and Repair Workers"
48,Texas,492,49172,39001,10171,910,214,3661,2338,1928,410,40,16,145,49-2000,"Electrical and Electronic Equipment Mechanics, Installers, and Repairers"
48,Texas,493,176025,129716,46309,6847,1135,31786,8415,6660,1755,228,40,1195,49-3000,"Vehicle and Mobile Equipment Mechanics, Installers, and Repairers"
48,Texas,499,191799,147261,44538,5877,1642,28295,9514,7763,1751,199,45,1118,49-9000,"Other Installation, Maintenance, and Repair Occupations"
48,Texas,511,65323,50539,14784,1384,702,9438,3510,2853,657,55,25,419,51-1000,Supervisors of Production Workers
48,Texas,512,70920,43486,27434,2727,319,13746,3571,2384,1187,96,16,572,51-2000,Assemblers and Fabricators
48,Texas,513,57166,31307,25859,2969,426,16367,2710,1649,1061,102,14,688,51-3000,Food Processing Workers
48,Texas,514,146113,90289,55824,6345,813,40116,6989,4743,2246,197,28,1618,51-4000,Metal Workers and Plastic Workers
48,Texas,5151,13232,9833,3399,310,42,1860,672,523,149,12,4,83,51-5100,Printing Workers
48,Texas,516,34665,15858,18807,2155,179,12538,1833,995,838,84,9,550,51-6000,"Textile, Apparel, and Furnishings Workers"
48,Texas,517,8705,5079,3626,39,0,3414,468,330,138,2,0,128,51-7000,Woodworkers
48,Texas,518,26587,23391,3196,238,252,1671,1401,1270,131,8,6,76,51-8000,Plant and System Operators
48,Texas,519,238876,166583,72293,8334,1100,46155,11984,8866,3118,305,59,1995,51-9000,Other Production Occupations
48,Texas,531,24293,20095,4198,331,140,1911,1185,1022,163,11,8,83,53-1000,Supervisors of Transportation and Material Moving Workers
48,Texas,532,32147,29542,2605,157,230,292,1771,1640,131,9,11,15,53-2000,Air Transportation Workers
48,Texas,533,407567,304727,102840,14668,3713,55691,19285,15235,4050,490,122,2355,53-3000,Motor Vehicle Operators
48,Texas,534,10654,10152,502,59,7,347,562,541,21,2,1,13,53-4000,Rail Transportation Workers
48,Texas,535,6053,5261,792,131,0,213,284,247,37,5,0,10,53-5000,Water Transportation Workers
48,Texas,536,24654,20526,4128,310,193,1503,1239,1052,187,15,10,75,53-6000,Other Transportation Workers
48,Texas,537,492358,375757,116601,16704,2754,73908,24857,19867,4990,635,107,3197,53-7000,Material Moving Workers
49,Utah,111,20041,18904,1137,26,114,96,1122,1062,60,1,7,6,11-1000,Top Executives
49,Utah,112,12145,11553,592,0,172,73,618,593,25,0,4,3,11-2000,"Advertising, Marketing, Promotions, Public Relations, and Sales Managers"
49,Utah,113,31824,29899,1925,99,158,420,1692,1597,95,5,11,17,11-3000,Operations Specialties Managers
49,Utah,119,85823,79022,6801,270,703,1868,4566,4285,281,11,33,66,11-9000,Other Management Occupations
49,Utah,131,42622,40306,2316,136,383,469,2317,2175,142,10,31,20,13-1000,Business Operations Specialists
49,Utah,132,33387,31143,2244,95,286,431,1808,1709,99,5,17,13,13-2000,Financial Specialists
49,Utah,1512,55531,49959,5572,61,542,717,2954,2716,238,5,29,24,15-1200,Computer Occupations
49,Utah,152,3402,2893,509,126,0,120,157,145,12,1,0,2,15-2000,Mathematical Science Occupations
49,Utah,171,1670,1484,186,0,0,33,95,86,9,0,0,1,17-1000,"Architects, Surveyors, and Cartographers"
49,Utah,172,17964,16345,1619,0,278,133,989,910,79,0,10,6,17-2000,Engineers
49,Utah,173,7435,6728,707,11,55,75,423,387,36,1,4,3,17-3000,"Drafters, Engineering Technicians, and Mapping Technicians"
49,Utah,191,2036,1707,329,0,69,17,138,111,27,0,3,2,19-1000,Life Scientists
49,Utah,192,3666,3000,666,0,16,0,214,174,40,0,1,0,19-2000,Physical Scientists
49,Utah,193,2691,2349,342,0,38,0,151,138,13,0,2,0,19-3000,Social Scientists and Related Workers
49,Utah,194,4922,4213,709,22,29,257,301,265,36,1,2,7,19-4000,"Life, Physical, and Social Science Technicians"
49,Utah,195,618,597,21,0,0,21,38,37,1,0,0,1,19-5000,Occupational Health and Safety Specialists and Technicians
49,Utah,211,16611,15598,1013,32,221,335,1014,961,53,5,7,10,21-1000,"Counselors, Social Workers, and Other Community and Social Service Specialists"
49,Utah,212,2330,2032,298,0,87,43,140,123,17,0,3,2,21-2000,Religious Workers
49,Utah,231,8226,8008,218,0,0,0,434,423,11,0,1,0,23-1000,"Lawyers, Judges, and Related Workers"
49,Utah,232,4794,4589,205,38,88,0,240,225,15,2,6,1,23-2000,Legal Support Workers
49,Utah,251,15558,13541,2017,16,156,44,1056,913,143,1,15,5,25-1000,Postsecondary Teachers
49,Utah,252,46605,44256,2349,92,476,541,3043,2912,131,5,23,25,25-2000,"Preschool, Elementary, Middle, Secondary, and Special Education Teachers"
49,Utah,253,12944,12272,672,55,59,175,894,849,45,2,5,9,25-3000,Other Teachers and Instructors
49,Utah,254,2745,2665,80,0,21,0,200,192,8,0,1,1,25-4000,"Librarians, Curators, and Archivists"
49,Utah,259,14013,12980,1033,50,320,124,1036,957,79,5,16,8,25-9000,Other Educational Instruction and Library Occupations
49,Utah,271,13111,12079,1032,132,123,294,736,690,46,3,7,12,27-1000,Art and Design Workers
49,Utah,272,7020,6393,627,0,20,246,563,531,32,0,2,4,27-2000,"Entertainers and Performers, Sports and Related Workers"
49,Utah,273,8705,8013,692,5,148,86,579,534,45,1,4,7,27-3000,Media and Communication Workers
49,Utah,274,4387,3943,444,49,18,224,259,248,11,1,1,3,27-4000,Media and Communication Equipment Workers
49,Utah,291,49709,47149,2560,58,197,152,2765,2629,136,3,10,8,29-1000,Healthcare Diagnosing or Treating Practitioners
49,Utah,292,21210,19479,1731,133,247,325,1126,1053,73,4,12,10,29-2000,Health Technologists and Technicians
49,Utah,299,853,766,87,0,0,31,46,44,2,0,0,1,29-9000,Other Healthcare Practitioners and Technical Occupations
49,Utah,3111,18787,16738,2049,238,473,601,1019,933,86,8,18,24,31-1100,"Home Health and Personal Care Aides; and Nursing Assistants, Orderlies, and Psychiatric Aides"
49,Utah,312,1264,1188,76,0,14,15,82,76,6,0,1,1,31-2000,Occupational Therapy and Physical Therapist Assistants and Aides
49,Utah,319,16890,15713,1177,82,115,578,907,851,56,5,7,22,31-9000,Other Healthcare Support Occupations
49,Utah,331,2046,2015,31,0,26,0,124,121,3,0,2,0,33-1000,Supervisors of Protective Service Workers
49,Utah,332,2480,2430,50,0,0,23,137,135,2,0,0,1,33-2000,Firefighting and Prevention Workers
49,Utah,333,8384,7966,418,12,40,73,464,446,18,1,2,3,33-3000,Law Enforcement Workers
49,Utah,339,8930,8525,405,33,49,82,594,573,21,2,3,2,33-9000,Other Protective Service Workers
49,Utah,351,9431,7992,1439,36,63,707,451,398,53,3,4,22,35-1000,Supervisors of Food Preparation and Serving Workers
49,Utah,352,30533,22598,7935,502,766,4987,1756,1488,268,19,31,150,35-2000,Cooks and Food Preparation Workers
49,Utah,353,25663,22863,2800,241,306,1273,1495,1358,137,8,15,51,35-3000,Food and Beverage Serving Workers
49,Utah,359,7094,5554,1540,85,51,1155,488,435,53,4,3,33,35-9000,Other Food Preparation and Serving Related Workers
49,Utah,371,3580,2885,695,21,352,303,162,139,23,2,8,11,37-1000,Supervisors of Building and Grounds Cleaning and Maintenance Workers
49,Utah,372,36149,24885,11264,944,1922,6178,2046,1654,392,37,66,214,37-2000,Building Cleaning and Pest Control Workers
49,Utah,373,11331,8018,3313,416,147,2682,676,582,94,10,7,71,37-3000,Grounds Maintenance Workers
49,Utah,391,933,894,39,0,0,0,43,40,3,0,0,0,39-1000,Supervisors of Personal Care and Service Workers
49,Utah,392,2584,2301,283,0,17,129,151,142,9,0,2,4,39-2000,Animal Care and Service Workers
49,Utah,393,3157,3144,13,0,0,0,219,218,1,0,0,0,39-3000,Entertainment Attendants and Related Workers
49,Utah,394,237,237,0,0,0,0,18,18,0,0,0,0,39-4000,Funeral Service Workers
49,Utah,395,12460,10455,2005,39,53,378,659,596,63,2,2,11,39-5000,Personal Appearance Workers
49,Utah,396,581,520,61,0,0,0,19,18,1,0,0,0,39-6000,"Baggage Porters, Bellhops, and Concierges"
49,Utah,397,861,845,16,0,0,0,70,66,4,0,0,0,39-7000,Tour and Travel Guides
49,Utah,399,17119,16090,1029,0,149,576,1254,1182,72,3,14,26,39-9000,Other Personal Care and Service Workers
49,Utah,411,42351,38906,3445,241,691,912,2146,2006,140,10,28,30,41-1000,Supervisors of Sales Workers
49,Utah,412,56367,51440,4927,212,479,1728,3574,3324,250,10,31,78,41-2000,Retail Sales Workers
49,Utah,413,18169,16968,1201,46,263,551,928,880,48,2,10,16,41-3000,"Sales Representatives, Services"
49,Utah,414,12190,11574,616,20,117,344,658,632,26,1,6,8,41-4000,"Sales Representatives, Wholesale and Manufacturing"
49,Utah,419,15936,15113,823,101,215,284,924,884,40,3,10,8,41-9000,Other Sales and Related Workers
49,Utah,431,12922,12097,825,60,91,208,712,672,40,4,4,8,43-1000,Supervisors of Office and Administrative Support Workers
49,Utah,432,1272,1245,27,0,27,0,66,65,1,0,1,0,43-2000,Communications Equipment Operators
49,Utah,433,26230,24253,1977,169,186,688,1446,1360,86,6,14,26,43-3000,Financial Clerks
49,Utah,434,75825,69110,6715,675,1563,1774,4232,3926,306,29,57,75,43-4000,Information and Record Clerks
49,Utah,435,21311,18730,2581,248,387,1066,1084,999,85,10,14,31,43-5000,"Material Recording, Scheduling, Dispatching, and Distributing Workers"
49,Utah,436,27409,26399,1010,135,184,272,1883,1812,71,6,12,17,43-6000,Secretaries and Administrative Assistants
49,Utah,439,27162,24995,2167,144,338,885,1576,1497,79,3,14,21,43-9000,Other Office and Administrative Support Workers
49,Utah,451,306,267,39,0,5,26,24,21,3,0,1,1,45-1000,"Supervisors of Farming, Fishing, and Forestry Workers"
49,Utah,452,4158,2914,1244,94,81,1057,383,316,67,7,4,54,45-2000,Agricultural Workers
49,Utah,453,133,101,32,0,0,19,8,6,2,0,0,1,45-3000,Fishing and Hunting Workers
49,Utah,454,103,103,0,0,0,0,11,11,0,0,0,0,45-4000,"Forest, Conservation, and Logging Workers"
49,Utah,471,7196,6636,560,77,0,407,423,401,22,3,0,13,47-1000,Supervisors of Construction and Extraction Workers
49,Utah,472,66968,49756,17212,1508,1318,13457,3156,2651,505,47,47,366,47-2000,Construction Trades Workers
49,Utah,473,152,128,24,0,0,24,15,13,2,0,1,1,47-3000,"Helpers, Construction Trades"
49,Utah,474,3010,2701,309,0,0,222,178,168,10,0,1,6,47-4000,Other Construction and Related Workers
49,Utah,475,3540,3242,298,40,34,186,234,215,19,2,3,11,47-5000,Extraction Workers
49,Utah,491,2449,2293,156,42,84,22,131,125,6,1,3,1,49-1000,"Supervisors of Installation, Maintenance, and Repair Workers"
49,Utah,492,4991,4665,326,44,74,98,256,244,12,1,2,5,49-2000,"Electrical and Electronic Equipment Mechanics, Installers, and Repairers"
49,Utah,493,19178,16560,2618,116,224,1899,902,815,87,4,9,58,49-3000,"Vehicle and Mobile Equipment Mechanics, Installers, and Repairers"
49,Utah,499,18978,16848,2130,207,343,803,976,898,78,7,12,31,49-9000,"Other Installation, Maintenance, and Repair Occupations"
49,Utah,511,8692,7288,1404,74,276,696,454,394,60,4,12,29,51-1000,Supervisors of Production Workers
49,Utah,512,13727,9675,4052,345,201,2085,656,502,154,10,9,66,51-2000,Assemblers and Fabricators
49,Utah,513,7663,5795,1868,35,268,1081,414,333,81,2,9,40,51-3000,Food Processing Workers
49,Utah,514,14595,12029,2566,204,185,1364,727,628,99,8,9,50,51-4000,Metal Workers and Plastic Workers
49,Utah,5151,2252,1822,430,106,87,129,129,115,14,3,2,6,51-5100,Printing Workers
49,Utah,516,4583,3025,1558,168,131,673,298,235,63,4,6,28,51-6000,"Textile, Apparel, and Furnishings Workers"
49,Utah,517,2393,2083,310,0,50,243,122,110,12,0,1,8,51-7000,Woodworkers
49,Utah,518,2750,2692,58,0,0,23,151,148,3,0,0,1,51-8000,Plant and System Operators
49,Utah,519,35580,27009,8571,793,1016,4686,1752,1434,318,30,34,157,51-9000,Other Production Occupations
49,Utah,531,2162,1738,424,0,21,217,106,95,11,0,1,7,53-1000,Supervisors of Transportation and Material Moving Workers
49,Utah,532,4481,4342,139,27,26,18,246,238,8,1,2,1,53-2000,Air Transportation Workers
49,Utah,533,35078,31408,3670,417,373,1314,1854,1722,132,11,16,43,53-3000,Motor Vehicle Operators
49,Utah,534,1279,1229,50,0,33,0,81,79,2,0,1,0,53-4000,Rail Transportation Workers
49,Utah,535,65,65,0,0,0,0,9,9,0,0,0,0,53-5000,Water Transportation Workers
49,Utah,536,2099,1966,133,0,0,30,110,106,4,0,0,1,53-6000,Other Transportation Workers
49,Utah,537,52183,43552,8631,965,1048,4583,2875,2512,363,36,42,166,53-7000,Material Moving Workers
50,Vermont,111,3758,3572,186,0,0,0,223,210,13,0,0,0,11-1000,Top Executives
50,Vermont,112,1793,1668,125,0,0,0,96,93,3,0,0,0,11-2000,"Advertising, Marketing, Promotions, Public Relations, and Sales Managers"
50,Vermont,113,5810,5581,229,0,0,25,307,294,13,0,0,1,11-3000,Operations Specialties Managers
50,Vermont,119,21644,20729,915,0,0,0,1249,1210,39,0,1,0,11-9000,Other Management Occupations
50,Vermont,131,8425,8077,348,0,0,0,436,423,13,0,0,0,13-1000,Business Operations Specialists
50,Vermont,132,5792,5541,251,0,0,0,288,271,17,0,0,0,13-2000,Financial Specialists
50,Vermont,1512,7483,6833,650,0,18,0,396,361,35,0,1,0,15-1200,Computer Occupations
50,Vermont,152,485,485,0,0,0,0,22,22,0,0,0,0,15-2000,Mathematical Science Occupations
50,Vermont,171,374,367,7,0,0,0,27,26,1,0,0,0,17-1000,"Architects, Surveyors, and Cartographers"
50,Vermont,172,4505,4122,383,0,40,0,236,219,17,0,2,0,17-2000,Engineers
50,Vermont,173,1378,1354,24,0,0,0,79,77,2,0,0,0,17-3000,"Drafters, Engineering Technicians, and Mapping Technicians"
50,Vermont,191,815,770,45,0,0,0,53,50,3,0,0,0,19-1000,Life Scientists
50,Vermont,192,455,321,134,0,0,0,27,24,3,0,0,0,19-2000,Physical Scientists
50,Vermont,193,998,949,49,0,0,0,46,43,3,0,0,0,19-3000,Social Scientists and Related Workers
50,Vermont,194,818,818,0,0,0,0,68,63,5,0,0,2,19-4000,"Life, Physical, and Social Science Technicians"
50,Vermont,195,121,121,0,0,0,0,8,8,0,0,0,0,19-5000,Occupational Health and Safety Specialists and Technicians
50,Vermont,211,6992,6759,233,13,0,0,384,374,10,1,0,0,21-1000,"Counselors, Social Workers, and Other Community and Social Service Specialists"
50,Vermont,212,520,493,27,0,0,0,35,33,2,0,0,0,21-2000,Religious Workers
50,Vermont,231,2374,2209,165,0,0,0,129,123,6,0,0,0,23-1000,"Lawyers, Judges, and Related Workers"
50,Vermont,232,828,828,0,0,0,0,41,41,0,0,0,0,23-2000,Legal Support Workers
50,Vermont,251,4019,3479,540,0,0,0,210,184,26,0,0,0,25-1000,Postsecondary Teachers
50,Vermont,252,12203,11695,508,0,107,0,746,720,26,0,3,0,25-2000,"Preschool, Elementary, Middle, Secondary, and Special Education Teachers"
50,Vermont,253,1505,1390,115,0,0,0,119,113,6,0,0,0,25-3000,Other Teachers and Instructors
50,Vermont,254,856,825,31,0,0,0,60,56,4,0,0,0,25-4000,"Librarians, Curators, and Archivists"
50,Vermont,259,3998,3892,106,0,0,0,238,228,10,0,0,0,25-9000,Other Educational Instruction and Library Occupations
50,Vermont,271,2275,2161,114,0,0,0,132,125,7,0,0,0,27-1000,Art and Design Workers
50,Vermont,272,1399,1315,84,0,6,0,126,116,10,0,1,0,27-2000,"Entertainers and Performers, Sports and Related Workers"
50,Vermont,273,2435,2317,118,0,9,0,122,117,5,0,1,0,27-3000,Media and Communication Workers
50,Vermont,274,724,664,60,0,0,0,42,39,3,0,0,0,27-4000,Media and Communication Equipment Workers
50,Vermont,291,14067,13088,979,0,34,78,745,708,37,0,2,1,29-1000,Healthcare Diagnosing or Treating Practitioners
50,Vermont,292,5324,5163,161,0,13,0,271,260,11,0,1,0,29-2000,Health Technologists and Technicians
50,Vermont,299,113,113,0,0,0,0,11,11,0,0,0,0,29-9000,Other Healthcare Practitioners and Technical Occupations
50,Vermont,3111,7195,6773,422,0,0,0,378,362,16,0,0,1,31-1100,"Home Health and Personal Care Aides; and Nursing Assistants, Orderlies, and Psychiatric Aides"
50,Vermont,312,165,165,0,0,0,0,13,13,0,0,0,0,31-2000,Occupational Therapy and Physical Therapist Assistants and Aides
50,Vermont,319,2793,2419,374,0,0,0,130,121,9,0,0,0,31-9000,Other Healthcare Support Occupations
50,Vermont,331,270,270,0,0,0,0,15,15,0,0,0,0,33-1000,Supervisors of Protective Service Workers
50,Vermont,332,309,309,0,0,0,0,14,14,0,0,0,0,33-2000,Firefighting and Prevention Workers
50,Vermont,333,1448,1438,10,0,0,0,88,87,1,0,0,0,33-3000,Law Enforcement Workers
50,Vermont,339,1435,1286,149,0,0,0,119,115,4,0,0,0,33-9000,Other Protective Service Workers
50,Vermont,351,2387,2237,150,0,0,43,134,129,5,0,0,1,35-1000,Supervisors of Food Preparation and Serving Workers
50,Vermont,352,6837,6470,367,0,0,75,353,334,19,0,0,2,35-2000,Cooks and Food Preparation Workers
50,Vermont,353,6872,6594,278,0,0,0,409,397,12,0,0,1,35-3000,Food and Beverage Serving Workers
50,Vermont,359,2298,2148,150,0,0,0,177,170,7,0,0,0,35-9000,Other Food Preparation and Serving Related Workers
50,Vermont,371,759,727,32,0,0,0,42,41,1,0,0,0,37-1000,Supervisors of Building and Grounds Cleaning and Maintenance Workers
50,Vermont,372,8723,7875,848,0,36,15,485,457,28,0,2,1,37-2000,Building Cleaning and Pest Control Workers
50,Vermont,373,3125,3043,82,0,0,0,245,240,5,0,0,0,37-3000,Grounds Maintenance Workers
50,Vermont,391,112,112,0,0,0,0,8,8,0,0,0,0,39-1000,Supervisors of Personal Care and Service Workers
50,Vermont,392,648,648,0,0,0,0,41,41,0,0,0,0,39-2000,Animal Care and Service Workers
50,Vermont,393,634,622,12,0,0,12,87,84,3,0,0,1,39-3000,Entertainment Attendants and Related Workers
50,Vermont,394,64,64,0,0,0,0,6,6,0,0,0,0,39-4000,Funeral Service Workers
50,Vermont,395,1362,1232,130,0,0,0,65,58,7,0,0,0,39-5000,Personal Appearance Workers
50,Vermont,396,48,31,17,0,0,0,3,2,1,0,0,0,39-6000,"Baggage Porters, Bellhops, and Concierges"
50,Vermont,397,273,273,0,0,0,0,19,18,1,0,0,0,39-7000,Tour and Travel Guides
50,Vermont,399,5390,5205,185,0,11,60,390,381,9,0,1,1,39-9000,Other Personal Care and Service Workers
50,Vermont,411,9231,9093,138,0,23,12,494,484,10,0,1,1,41-1000,Supervisors of Sales Workers
50,Vermont,412,13590,12982,608,0,26,15,829,800,29,0,2,1,41-2000,Retail Sales Workers
50,Vermont,413,1736,1628,108,0,0,0,100,96,4,0,1,0,41-3000,"Sales Representatives, Services"
50,Vermont,414,2245,2201,44,0,0,0,111,107,4,0,0,0,41-4000,"Sales Representatives, Wholesale and Manufacturing"
50,Vermont,419,1845,1736,109,0,80,0,100,97,3,0,1,0,41-9000,Other Sales and Related Workers
50,Vermont,431,2405,2313,92,0,0,0,118,116,2,0,1,0,43-1000,Supervisors of Office and Administrative Support Workers
50,Vermont,432,160,160,0,0,0,0,10,10,0,0,0,0,43-2000,Communications Equipment Operators
50,Vermont,433,4683,4477,206,0,70,0,279,270,9,0,1,0,43-3000,Financial Clerks
50,Vermont,434,8864,8558,306,0,9,23,550,536,14,0,1,2,43-4000,Information and Record Clerks
50,Vermont,435,3984,3845,139,0,0,0,251,243,8,0,0,0,43-5000,"Material Recording, Scheduling, Dispatching, and Distributing Workers"
50,Vermont,436,6600,6271,329,0,13,0,402,384,18,0,2,0,43-6000,Secretaries and Administrative Assistants
50,Vermont,439,5452,4907,545,0,0,11,303,292,11,0,1,1,43-9000,Other Office and Administrative Support Workers
50,Vermont,451,29,29,0,0,0,0,5,5,0,0,0,0,45-1000,"Supervisors of Farming, Fishing, and Forestry Workers"
50,Vermont,452,3005,2617,388,0,0,352,213,200,13,0,0,10,45-2000,Agricultural Workers
50,Vermont,453,0,0,0,0,0,0,1,1,0,0,0,0,45-3000,Fishing and Hunting Workers
50,Vermont,454,744,744,0,0,0,0,57,56,1,0,0,0,45-4000,"Forest, Conservation, and Logging Workers"
50,Vermont,471,1622,1615,7,0,0,0,114,113,1,0,0,0,47-1000,Supervisors of Construction and Extraction Workers
50,Vermont,472,14847,14529,318,0,16,0,970,955,15,0,1,1,47-2000,Construction Trades Workers
50,Vermont,473,267,267,0,0,0,0,13,13,0,0,0,0,47-3000,"Helpers, Construction Trades"
50,Vermont,474,909,810,99,0,0,0,54,52,2,0,0,0,47-4000,Other Construction and Related Workers
50,Vermont,475,325,325,0,0,0,0,17,17,0,0,0,0,47-5000,Extraction Workers
50,Vermont,491,578,578,0,0,0,0,27,27,0,0,0,0,49-1000,"Supervisors of Installation, Maintenance, and Repair Workers"
50,Vermont,492,660,660,0,0,0,0,37,37,0,0,0,0,49-2000,"Electrical and Electronic Equipment Mechanics, Installers, and Repairers"
50,Vermont,493,4101,4066,35,0,0,0,232,231,1,0,0,0,49-3000,"Vehicle and Mobile Equipment Mechanics, Installers, and Repairers"
50,Vermont,499,3346,3261,85,0,0,0,209,200,9,0,0,0,49-9000,"Other Installation, Maintenance, and Repair Occupations"
50,Vermont,511,1435,1365,70,0,0,0,79,77,2,0,0,0,51-1000,Supervisors of Production Workers
50,Vermont,512,2411,2091,320,0,0,0,120,114,6,0,0,0,51-2000,Assemblers and Fabricators
50,Vermont,513,3278,3072,206,0,0,0,133,128,5,0,0,0,51-3000,Food Processing Workers
50,Vermont,514,3019,2890,129,0,0,0,195,187,8,0,0,0,51-4000,Metal Workers and Plastic Workers
50,Vermont,5151,647,647,0,0,0,0,25,25,0,0,0,0,51-5100,Printing Workers
50,Vermont,516,748,723,25,0,0,0,58,56,2,0,0,0,51-6000,"Textile, Apparel, and Furnishings Workers"
50,Vermont,517,542,530,12,0,0,0,44,42,2,0,0,0,51-7000,Woodworkers
50,Vermont,518,361,358,3,0,0,0,28,27,1,0,0,0,51-8000,Plant and System Operators
50,Vermont,519,7333,6757,576,0,0,0,412,389,23,0,0,0,51-9000,Other Production Occupations
50,Vermont,531,431,414,17,0,0,0,18,17,1,0,0,0,53-1000,Supervisors of Transportation and Material Moving Workers
50,Vermont,532,167,159,8,0,0,0,10,9,1,0,0,0,53-2000,Air Transportation Workers
50,Vermont,533,7281,6809,472,0,0,0,407,394,13,0,0,0,53-3000,Motor Vehicle Operators
50,Vermont,534,76,76,0,0,0,0,2,2,0,0,0,0,53-4000,Rail Transportation Workers
50,Vermont,535,104,104,0,0,0,0,6,6,0,0,0,0,53-5000,Water Transportation Workers
50,Vermont,536,198,198,0,0,0,0,10,10,0,0,0,0,53-6000,Other Transportation Workers
50,Vermont,537,6714,6500,214,0,64,0,488,470,18,0,2,1,53-7000,Material Moving Workers
51,Virginia,111,57001,49420,7581,895,547,118,3313,2917,396,27,30,7,11-1000,Top Executives
51,Virginia,112,26763,24302,2461,127,260,55,1597,1452,145,6,18,3,11-2000,"Advertising, Marketing, Promotions, Public Relations, and Sales Managers"
51,Virginia,113,103932,87476,16456,1013,1472,341,5964,5134,830,41,67,17,11-3000,Operations Specialties Managers
51,Virginia,119,261455,224481,36974,4304,4007,1539,15047,13163,1884,145,178,57,11-9000,Other Management Occupations
51,Virginia,131,171650,148964,22686,981,1978,465,9908,8685,1223,57,114,22,13-1000,Business Operations Specialists
51,Virginia,132,92177,75426,16751,694,1568,143,5355,4453,902,32,76,8,13-2000,Financial Specialists
51,Virginia,1512,200065,146076,53989,1114,1932,429,11006,8350,2656,47,110,19,15-1200,Computer Occupations
51,Virginia,152,23595,20098,3497,104,226,69,1387,1212,175,4,13,4,15-2000,Mathematical Science Occupations
51,Virginia,171,6790,5809,981,16,107,0,412,353,59,1,8,0,17-1000,"Architects, Surveyors, and Cartographers"
51,Virginia,172,56616,46344,10272,279,913,148,3279,2762,517,10,40,6,17-2000,Engineers
51,Virginia,173,15748,13614,2134,83,273,0,892,791,101,8,13,0,17-3000,"Drafters, Engineering Technicians, and Mapping Technicians"
51,Virginia,191,5859,4503,1356,22,45,44,397,313,84,2,5,2,19-1000,Life Scientists
51,Virginia,192,13158,9791,3367,0,80,74,811,628,183,0,4,4,19-2000,Physical Scientists
51,Virginia,193,12615,10489,2126,8,357,175,744,624,120,1,11,7,19-3000,Social Scientists and Related Workers
51,Virginia,194,9217,8167,1050,0,61,0,625,559,66,0,4,0,19-4000,"Life, Physical, and Social Science Technicians"
51,Virginia,195,1835,1692,143,54,0,0,116,104,12,1,1,0,19-5000,Occupational Health and Safety Specialists and Technicians
51,Virginia,211,54572,49980,4592,412,576,118,3003,2762,241,20,36,12,21-1000,"Counselors, Social Workers, and Other Community and Social Service Specialists"
51,Virginia,212,14440,12808,1632,100,134,21,936,829,107,9,5,1,21-2000,Religious Workers
51,Virginia,231,38508,35442,3066,174,159,66,2423,2237,186,8,11,3,23-1000,"Lawyers, Judges, and Related Workers"
51,Virginia,232,18784,15320,3464,257,364,74,1066,876,190,10,16,4,23-2000,Legal Support Workers
51,Virginia,251,36264,27890,8374,127,544,170,2176,1692,484,8,26,9,25-1000,Postsecondary Teachers
51,Virginia,252,148931,136974,11957,980,1274,454,9405,8666,739,43,83,19,25-2000,"Preschool, Elementary, Middle, Secondary, and Special Education Teachers"
51,Virginia,253,25700,22216,3484,424,284,161,1730,1505,225,13,22,5,25-3000,Other Teachers and Instructors
51,Virginia,254,9504,8665,839,17,108,0,641,593,48,1,5,0,25-4000,"Librarians, Curators, and Archivists"
51,Virginia,259,29560,25807,3753,325,518,250,1981,1726,255,20,31,9,25-9000,Other Educational Instruction and Library Occupations
51,Virginia,271,23231,20059,3172,177,277,35,1443,1251,192,8,18,4,27-1000,Art and Design Workers
51,Virginia,272,17084,14927,2157,129,268,34,1272,1140,132,7,15,1,27-2000,"Entertainers and Performers, Sports and Related Workers"
51,Virginia,273,28264,24835,3429,260,348,148,1813,1586,227,14,26,8,27-3000,Media and Communication Workers
51,Virginia,274,6432,5784,648,0,216,18,460,413,47,0,11,1,27-4000,Media and Communication Equipment Workers
51,Virginia,291,145437,122676,22761,634,1077,126,8171,7000,1171,27,65,8,29-1000,Healthcare Diagnosing or Treating Practitioners
51,Virginia,292,70714,62020,8694,607,951,270,3674,3235,439,25,44,9,29-2000,Health Technologists and Technicians
51,Virginia,299,3034,2410,624,61,57,12,150,120,30,1,2,1,29-9000,Other Healthcare Practitioners and Technical Occupations
51,Virginia,3111,66394,54687,11707,1300,804,148,3434,2921,513,48,42,10,31-1100,"Home Health and Personal Care Aides; and Nursing Assistants, Orderlies, and Psychiatric Aides"
51,Virginia,312,3608,3444,164,0,17,0,215,205,10,0,1,0,31-2000,Occupational Therapy and Physical Therapist Assistants and Aides
51,Virginia,319,31787,26513,5274,771,636,181,1705,1432,273,32,36,12,31-9000,Other Healthcare Support Occupations
51,Virginia,331,8564,8367,197,0,0,0,510,500,10,0,1,0,33-1000,Supervisors of Protective Service Workers
51,Virginia,332,9550,9258,292,17,43,0,511,497,14,3,1,0,33-2000,Firefighting and Prevention Workers
51,Virginia,333,44873,42844,2029,286,219,39,2336,2231,105,12,10,2,33-3000,Law Enforcement Workers
51,Virginia,339,38651,34159,4492,701,338,238,2624,2433,191,21,19,6,33-9000,Other Protective Service Workers
51,Virginia,351,26488,19574,6914,1778,646,182,1328,1033,295,51,28,11,35-1000,Supervisors of Food Preparation and Serving Workers
51,Virginia,352,76300,54386,21914,9402,2002,1933,4151,3317,834,274,81,64,35-2000,Cooks and Food Preparation Workers
51,Virginia,353,81691,68477,13214,3706,1329,1198,4887,4261,626,109,61,44,35-3000,Food and Beverage Serving Workers
51,Virginia,359,24523,19826,4697,1656,665,390,1623,1409,214,50,26,17,35-9000,Other Food Preparation and Serving Related Workers
51,Virginia,371,10312,8355,1957,953,407,184,526,439,87,36,18,9,37-1000,Supervisors of Building and Grounds Cleaning and Maintenance Workers
51,Virginia,372,90206,56731,33475,18657,5516,2552,4606,3375,1231,582,226,106,37-2000,Building Cleaning and Pest Control Workers
51,Virginia,373,30733,22924,7809,5169,408,1462,1740,1505,235,129,12,52,37-3000,Grounds Maintenance Workers
51,Virginia,391,2295,2098,197,0,0,0,125,111,14,0,0,0,39-1000,Supervisors of Personal Care and Service Workers
51,Virginia,392,10738,10015,723,20,144,105,686,636,50,2,6,10,39-2000,Animal Care and Service Workers
51,Virginia,393,6900,6425,475,36,71,0,579,549,30,3,4,0,39-3000,Entertainment Attendants and Related Workers
51,Virginia,394,1520,1482,38,12,0,0,79,77,2,1,0,0,39-4000,Funeral Service Workers
51,Virginia,395,34201,20785,13416,740,663,122,1609,994,615,25,24,6,39-5000,Personal Appearance Workers
51,Virginia,396,1364,1085,279,0,0,0,60,45,15,0,0,0,39-6000,"Baggage Porters, Bellhops, and Concierges"
51,Virginia,397,1422,1232,190,26,42,0,132,116,16,2,1,0,39-7000,Tour and Travel Guides
51,Virginia,399,54862,42511,12351,2090,2788,527,3899,3214,685,98,133,24,39-9000,Other Personal Care and Service Workers
51,Virginia,411,103603,89033,14570,1747,885,680,5354,4673,681,53,49,26,41-1000,Supervisors of Sales Workers
51,Virginia,412,170473,143328,27145,3710,2100,954,10759,9357,1402,141,103,48,41-2000,Retail Sales Workers
51,Virginia,413,36455,32453,4002,353,404,70,2075,1866,209,14,26,5,41-3000,"Sales Representatives, Services"
51,Virginia,414,23813,21960,1853,111,101,13,1347,1259,88,7,5,1,41-4000,"Sales Representatives, Wholesale and Manufacturing"
51,Virginia,419,34052,29651,4401,198,518,52,2060,1821,239,12,29,4,41-9000,Other Sales and Related Workers
51,Virginia,431,38499,33561,4938,548,592,103,2200,1947,253,24,30,6,43-1000,Supervisors of Office and Administrative Support Workers
51,Virginia,432,2587,2360,227,44,0,0,147,139,8,2,0,0,43-2000,Communications Equipment Operators
51,Virginia,433,59176,52297,6879,660,876,282,3304,2950,354,34,49,10,43-3000,Financial Clerks
51,Virginia,434,129439,114025,15414,1874,1805,607,7297,6483,814,73,89,29,43-4000,Information and Record Clerks
51,Virginia,435,44997,39222,5775,693,454,174,2375,2109,266,28,20,6,43-5000,"Material Recording, Scheduling, Dispatching, and Distributing Workers"
51,Virginia,436,73950,66312,7638,744,1356,323,4576,4122,454,37,63,16,43-6000,Secretaries and Administrative Assistants
51,Virginia,439,66124,59179,6945,595,983,215,4128,3726,402,32,46,10,43-9000,Other Office and Administrative Support Workers
51,Virginia,451,853,799,54,0,15,25,52,46,6,1,1,3,45-1000,"Supervisors of Farming, Fishing, and Forestry Workers"
51,Virginia,452,9686,6513,3173,796,109,2061,626,479,147,27,3,108,45-2000,Agricultural Workers
51,Virginia,453,1019,866,153,0,0,153,63,61,2,0,0,2,45-3000,Fishing and Hunting Workers
51,Virginia,454,2326,2223,103,84,0,19,124,121,3,2,0,1,45-4000,"Forest, Conservation, and Logging Workers"
51,Virginia,471,21802,17426,4376,2405,480,724,1107,952,155,62,23,28,47-1000,Supervisors of Construction and Extraction Workers
51,Virginia,472,165464,107687,57777,34298,6498,10692,7337,5706,1631,831,212,286,47-2000,Construction Trades Workers
51,Virginia,473,1164,959,205,177,0,0,106,98,8,6,0,0,47-3000,"Helpers, Construction Trades"
51,Virginia,474,7599,6523,1076,617,73,205,367,333,34,14,4,5,47-4000,Other Construction and Related Workers
51,Virginia,475,3489,3409,80,60,0,0,218,215,3,2,0,0,47-5000,Extraction Workers
51,Virginia,491,7537,6675,862,465,22,53,396,368,28,9,3,2,49-1000,"Supervisors of Installation, Maintenance, and Repair Workers"
51,Virginia,492,13298,11508,1790,421,174,139,674,599,75,11,9,6,49-2000,"Electrical and Electronic Equipment Mechanics, Installers, and Repairers"
51,Virginia,493,43503,36931,6572,1688,1133,718,2167,1920,247,55,33,23,49-3000,"Vehicle and Mobile Equipment Mechanics, Installers, and Repairers"
51,Virginia,499,51758,44779,6979,2193,827,447,2702,2433,269,68,34,16,49-9000,"Other Installation, Maintenance, and Repair Occupations"
51,Virginia,511,18098,16296,1802,286,105,104,962,888,74,8,7,3,51-1000,Supervisors of Production Workers
51,Virginia,512,13372,11574,1798,221,75,93,829,723,106,10,5,3,51-2000,Assemblers and Fabricators
51,Virginia,513,13805,10811,2994,925,283,361,713,590,123,32,11,14,51-3000,Food Processing Workers
51,Virginia,514,28365,25821,2544,760,148,473,1433,1323,110,22,6,15,51-4000,Metal Workers and Plastic Workers
51,Virginia,5151,4952,4105,847,314,46,36,271,232,39,11,4,1,51-5100,Printing Workers
51,Virginia,516,10401,7786,2615,938,142,439,562,424,138,39,8,16,51-6000,"Textile, Apparel, and Furnishings Workers"
51,Virginia,517,2859,2555,304,55,0,132,175,159,16,3,0,5,51-7000,Woodworkers
51,Virginia,518,6255,5333,922,229,123,66,334,294,40,7,6,1,51-8000,Plant and System Operators
51,Virginia,519,67575,57873,9702,2492,821,1309,3534,3120,414,80,25,54,51-9000,Other Production Occupations
51,Virginia,531,5780,5177,603,26,103,27,286,259,27,1,4,1,53-1000,Supervisors of Transportation and Material Moving Workers
51,Virginia,532,6090,5386,704,68,6,0,368,329,39,3,1,0,53-2000,Air Transportation Workers
51,Virginia,533,108343,84731,23612,4733,1811,778,5236,4359,877,133,68,23,53-3000,Motor Vehicle Operators
51,Virginia,534,2147,2106,41,0,0,0,132,129,3,0,0,0,53-4000,Rail Transportation Workers
51,Virginia,535,1831,1788,43,0,0,0,108,102,6,0,0,1,53-5000,Water Transportation Workers
51,Virginia,536,6124,4818,1306,78,319,0,300,245,55,4,12,0,53-6000,Other Transportation Workers
51,Virginia,537,115644,101201,14443,4144,1228,1509,6480,5852,628,146,54,55,53-7000,Material Moving Workers
53,Washington,111,48138,42845,5293,57,299,394,2669,2347,322,1,17,17,11-1000,Top Executives
53,Washington,112,27883,23619,4264,32,273,366,1486,1300,186,2,8,16,11-2000,"Advertising, Marketing, Promotions, Public Relations, and Sales Managers"
53,Washington,113,76795,64908,11887,203,325,899,4232,3603,629,11,15,41,11-3000,Operations Specialties Managers
53,Washington,119,230112,196146,33966,827,953,5592,12711,11064,1647,29,45,230,11-9000,Other Management Occupations
53,Washington,131,123589,108550,15039,127,620,1058,6784,6012,772,9,28,48,13-1000,Business Operations Specialists
53,Washington,132,70234,58883,11351,23,282,449,3914,3302,612,1,13,21,13-2000,Financial Specialists
53,Washington,1512,168175,108323,59852,191,897,1869,8439,5842,2597,11,47,79,15-1200,Computer Occupations
53,Washington,152,7735,5705,2030,0,0,0,394,316,78,0,1,0,15-2000,Mathematical Science Occupations
53,Washington,171,7496,6163,1333,0,0,116,417,345,72,0,0,5,17-1000,"Architects, Surveyors, and Cartographers"
53,Washington,172,63277,49847,13430,126,368,486,3470,2780,690,6,19,23,17-2000,Engineers
53,Washington,173,15526,13756,1770,25,86,174,887,786,101,2,3,7,17-3000,"Drafters, Engineering Technicians, and Mapping Technicians"
53,Washington,191,8828,6992,1836,26,37,25,513,424,89,1,1,1,19-1000,Life Scientists
53,Washington,192,12149,8342,3807,19,205,110,683,492,191,1,8,4,19-2000,Physical Scientists
53,Washington,193,6908,6379,529,0,0,12,407,369,38,1,2,1,19-3000,Social Scientists and Related Workers
53,Washington,194,9912,8966,946,0,0,230,591,530,61,0,0,10,19-4000,"Life, Physical, and Social Science Technicians"
53,Washington,195,1865,1733,132,0,0,4,107,99,8,0,0,1,19-5000,Occupational Health and Safety Specialists and Technicians
53,Washington,211,46590,40723,5867,115,218,1317,2649,2390,259,8,10,44,21-1000,"Counselors, Social Workers, and Other Community and Social Service Specialists"
53,Washington,212,11920,10021,1899,61,88,86,696,606,90,3,5,4,21-2000,Religious Workers
53,Washington,231,20375,18637,1738,0,31,34,1112,1022,90,0,4,3,23-1000,"Lawyers, Judges, and Related Workers"
53,Washington,232,12150,11072,1078,287,32,41,659,614,45,2,4,2,23-2000,Legal Support Workers
53,Washington,251,26109,20413,5696,86,163,229,1562,1237,325,6,11,14,25-1000,Postsecondary Teachers
53,Washington,252,100974,92510,8464,196,498,1100,6310,5818,492,10,19,63,25-2000,"Preschool, Elementary, Middle, Secondary, and Special Education Teachers"
53,Washington,253,21145,18519,2626,138,81,351,1442,1276,166,3,3,17,25-3000,Other Teachers and Instructors
53,Washington,254,5992,5633,359,20,47,0,393,367,26,1,1,0,25-4000,"Librarians, Curators, and Archivists"
53,Washington,259,33277,28744,4533,104,162,1000,2159,1884,275,8,10,56,25-9000,Other Educational Instruction and Library Occupations
53,Washington,271,29163,25051,4112,20,183,339,1772,1531,241,1,14,14,27-1000,Art and Design Workers
53,Washington,272,14730,13025,1705,8,46,86,1031,939,92,2,2,4,27-2000,"Entertainers and Performers, Sports and Related Workers"
53,Washington,273,21531,18025,3506,174,233,475,1303,1091,212,4,12,27,27-3000,Media and Communication Workers
53,Washington,274,7858,7279,579,0,0,45,491,451,40,0,0,4,27-4000,Media and Communication Equipment Workers
53,Washington,291,133278,110551,22727,146,746,593,7356,6213,1143,7,40,27,29-1000,Healthcare Diagnosing or Treating Practitioners
53,Washington,292,47677,39889,7788,54,76,352,2696,2311,385,5,4,21,29-2000,Health Technologists and Technicians
53,Washington,299,2264,2058,206,0,0,0,137,126,11,0,0,0,29-9000,Other Healthcare Practitioners and Technical Occupations
53,Washington,3111,73745,50747,22998,621,243,2620,4067,3010,1057,30,10,110,31-1100,"Home Health and Personal Care Aides; and Nursing Assistants, Orderlies, and Psychiatric Aides"
53,Washington,312,2852,2607,245,0,0,9,158,145,13,0,0,1,31-2000,Occupational Therapy and Physical Therapist Assistants and Aides
53,Washington,319,42716,35511,7205,176,140,1434,2339,1999,340,7,6,57,31-9000,Other Healthcare Support Occupations
53,Washington,331,5204,5054,150,20,0,90,339,327,12,2,0,5,33-1000,Supervisors of Protective Service Workers
53,Washington,332,9095,8895,200,16,0,14,560,541,19,1,0,4,33-2000,Firefighting and Prevention Workers
53,Washington,333,21400,20145,1255,0,114,268,1170,1120,50,0,3,8,33-3000,Law Enforcement Workers
53,Washington,339,26582,23888,2694,0,51,350,1676,1538,138,0,4,16,33-9000,Other Protective Service Workers
53,Washington,351,22664,17527,5137,442,70,1471,1118,910,208,10,3,57,35-1000,Supervisors of Food Preparation and Serving Workers
53,Washington,352,79173,59064,20109,1338,282,8924,4656,3769,887,40,13,336,35-2000,Cooks and Food Preparation Workers
53,Washington,353,71036,60798,10238,403,297,2962,4103,3546,557,16,17,136,35-3000,Food and Beverage Serving Workers
53,Washington,359,19114,14885,4229,237,135,2142,1270,1074,196,9,6,77,35-9000,Other Food Preparation and Serving Related Workers
53,Washington,371,8713,5511,3202,464,144,1644,395,292,103,9,7,43,37-1000,Supervisors of Building and Grounds Cleaning and Maintenance Workers
53,Washington,372,77953,49229,28724,2501,1139,12059,4634,3420,1214,69,43,462,37-2000,Building Cleaning and Pest Control Workers
53,Washington,373,26796,18058,8738,1123,139,6502,1700,1383,317,22,5,222,37-3000,Grounds Maintenance Workers
53,Washington,391,3472,2698,774,0,0,39,149,126,23,0,0,1,39-1000,Supervisors of Personal Care and Service Workers
53,Washington,392,8272,7639,633,24,32,69,516,482,34,2,2,3,39-2000,Animal Care and Service Workers
53,Washington,393,8822,7207,1615,34,0,43,590,500,90,1,0,2,39-3000,Entertainment Attendants and Related Workers
53,Washington,394,522,485,37,0,0,0,34,33,1,0,0,0,39-4000,Funeral Service Workers
53,Washington,395,25247,18042,7205,0,0,664,1292,953,339,1,1,25,39-5000,Personal Appearance Workers
53,Washington,396,1475,1117,358,0,0,0,72,59,13,0,0,0,39-6000,"Baggage Porters, Bellhops, and Concierges"
53,Washington,397,1191,1129,62,0,19,0,92,81,11,0,1,0,39-7000,Tour and Travel Guides
53,Washington,399,45021,37993,7028,316,523,2264,3093,2697,396,13,23,112,39-9000,Other Personal Care and Service Workers
53,Washington,411,94142,81073,13069,126,297,1883,4988,4382,606,9,15,91,41-1000,Supervisors of Sales Workers
53,Washington,412,125594,107878,17716,497,395,4607,8167,7163,1004,28,23,202,41-2000,Retail Sales Workers
53,Washington,413,29525,26786,2739,65,98,176,1636,1480,156,3,5,11,41-3000,"Sales Representatives, Services"
53,Washington,414,28544,26250,2294,0,147,248,1601,1482,119,0,6,14,41-4000,"Sales Representatives, Wholesale and Manufacturing"
53,Washington,419,29602,26441,3161,17,196,413,1726,1537,189,2,11,19,41-9000,Other Sales and Related Workers
53,Washington,431,26537,23994,2543,0,0,229,1486,1358,128,0,0,13,43-1000,Supervisors of Office and Administrative Support Workers
53,Washington,432,1260,1163,97,0,0,23,77,73,4,0,0,1,43-2000,Communications Equipment Operators
53,Washington,433,56326,50196,6130,11,231,819,3388,3046,342,1,10,38,43-3000,Financial Clerks
53,Washington,434,115689,100875,14814,332,630,3095,6826,6074,752,21,32,122,43-4000,Information and Record Clerks
53,Washington,435,45916,38328,7588,101,22,1144,2573,2199,374,6,1,42,43-5000,"Material Recording, Scheduling, Dispatching, and Distributing Workers"
53,Washington,436,55692,51618,4074,199,133,480,3535,3278,257,7,7,33,43-6000,Secretaries and Administrative Assistants
53,Washington,439,57590,50730,6860,72,78,1289,3541,3172,369,3,7,56,43-9000,Other Office and Administrative Support Workers
53,Washington,451,4209,1553,2656,11,4,2600,201,98,103,2,1,90,45-1000,"Supervisors of Farming, Fishing, and Forestry Workers"
53,Washington,452,45674,12474,33200,1502,211,30533,2680,1166,1514,55,6,1398,45-2000,Agricultural Workers
53,Washington,453,2991,2554,437,20,0,194,369,347,22,2,0,8,45-3000,Fishing and Hunting Workers
53,Washington,454,3195,2797,398,0,0,362,229,209,20,1,0,16,45-4000,"Forest, Conservation, and Logging Workers"
53,Washington,471,16224,13745,2479,152,0,1310,889,791,98,6,0,44,47-1000,Supervisors of Construction and Extraction Workers
53,Washington,472,147346,113499,33847,3228,1028,20071,7918,6662,1256,90,34,666,47-2000,Construction Trades Workers
53,Washington,473,475,463,12,0,0,0,27,24,3,0,0,1,47-3000,"Helpers, Construction Trades"
53,Washington,474,8253,7423,830,0,0,483,464,434,30,0,0,15,47-4000,Other Construction and Related Workers
53,Washington,475,1541,1510,31,0,0,0,101,100,1,0,0,0,47-5000,Extraction Workers
53,Washington,491,6243,5810,433,32,28,121,323,300,23,2,2,6,49-1000,"Supervisors of Installation, Maintenance, and Repair Workers"
53,Washington,492,11309,9390,1919,108,36,421,619,547,72,1,4,11,49-2000,"Electrical and Electronic Equipment Mechanics, Installers, and Repairers"
53,Washington,493,42765,37115,5650,35,229,1919,2304,2043,261,3,8,79,49-3000,"Vehicle and Mobile Equipment Mechanics, Installers, and Repairers"
53,Washington,499,44671,38505,6166,427,83,1987,2449,2186,263,10,1,68,49-9000,"Other Installation, Maintenance, and Repair Occupations"
53,Washington,511,16755,13794,2961,104,6,1431,910,778,132,4,1,49,51-1000,Supervisors of Production Workers
53,Washington,512,20245,14632,5613,280,80,1020,1067,806,261,7,3,43,51-2000,Assemblers and Fabricators
53,Washington,513,16462,10018,6444,294,63,2953,895,626,269,9,4,109,51-3000,Food Processing Workers
53,Washington,514,31644,26445,5199,54,29,1433,1621,1384,237,4,1,60,51-4000,Metal Workers and Plastic Workers
53,Washington,5151,3897,3155,742,0,19,293,211,177,34,0,1,10,51-5100,Printing Workers
53,Washington,516,7605,4155,3450,140,21,755,479,296,183,7,3,34,51-6000,"Textile, Apparel, and Furnishings Workers"
53,Washington,517,3676,2958,718,0,9,393,221,188,33,0,1,16,51-7000,Woodworkers
53,Washington,518,6219,5854,365,0,0,23,386,363,23,0,0,2,51-8000,Plant and System Operators
53,Washington,519,61701,47280,14421,468,195,5683,3437,2763,674,21,8,229,51-9000,Other Production Occupations
53,Washington,531,6041,5429,612,0,0,133,314,285,29,0,2,7,53-1000,Supervisors of Transportation and Material Moving Workers
53,Washington,532,9772,8654,1118,44,0,29,588,527,61,2,1,2,53-2000,Air Transportation Workers
53,Washington,533,95211,74589,20622,496,320,4517,5073,4252,821,20,14,162,53-3000,Motor Vehicle Operators
53,Washington,534,2666,2491,175,0,0,0,148,141,7,0,0,0,53-4000,Rail Transportation Workers
53,Washington,535,3612,3280,332,0,22,15,271,244,27,0,1,1,53-5000,Water Transportation Workers
53,Washington,536,6266,5070,1196,57,16,238,364,311,53,2,1,9,53-6000,Other Transportation Workers
53,Washington,537,123118,98092,25026,1183,218,13073,7245,6086,1159,48,16,553,53-7000,Material Moving Workers
54,West Virginia,111,7638,7488,150,0,0,0,418,413,5,0,0,0,11-1000,Top Executives
54,West Virginia,112,2230,2215,15,0,0,0,116,113,3,0,0,0,11-2000,"Advertising, Marketing, Promotions, Public Relations, and Sales Managers"
54,West Virginia,113,9819,9686,133,0,40,18,546,538,8,0,2,1,11-3000,Operations Specialties Managers
54,West Virginia,119,32958,32415,543,56,7,60,1832,1799,33,1,2,3,11-9000,Other Management Occupations
54,West Virginia,131,14217,14006,211,0,74,0,806,791,15,0,3,0,13-1000,Business Operations Specialists
54,West Virginia,132,10364,10190,174,0,0,0,607,593,14,0,1,0,13-2000,Financial Specialists
54,West Virginia,1512,12785,12358,427,13,30,0,719,697,22,1,2,0,15-1200,Computer Occupations
54,West Virginia,152,640,640,0,0,0,0,41,41,0,0,0,0,15-2000,Mathematical Science Occupations
54,West Virginia,171,609,571,38,0,0,0,29,28,1,0,0,0,17-1000,"Architects, Surveyors, and Cartographers"
54,West Virginia,172,6283,5917,366,0,9,32,342,330,12,0,1,1,17-2000,Engineers
54,West Virginia,173,3352,3259,93,0,15,0,192,188,4,0,1,0,17-3000,"Drafters, Engineering Technicians, and Mapping Technicians"
54,West Virginia,191,875,720,155,0,0,0,46,38,8,0,0,0,19-1000,Life Scientists
54,West Virginia,192,1544,1119,425,0,0,0,85,73,12,0,0,0,19-2000,Physical Scientists
54,West Virginia,193,1234,1217,17,0,0,0,61,60,1,0,0,0,19-3000,Social Scientists and Related Workers
54,West Virginia,194,2348,2231,117,0,0,0,154,147,7,0,0,0,19-4000,"Life, Physical, and Social Science Technicians"
54,West Virginia,195,349,349,0,0,0,0,27,27,0,0,0,0,19-5000,Occupational Health and Safety Specialists and Technicians
54,West Virginia,211,10897,10748,149,0,16,10,612,599,13,0,2,1,21-1000,"Counselors, Social Workers, and Other Community and Social Service Specialists"
54,West Virginia,212,3006,2962,44,0,0,14,194,188,6,0,0,3,21-2000,Religious Workers
54,West Virginia,231,3338,3327,11,0,11,0,203,201,2,0,2,0,23-1000,"Lawyers, Judges, and Related Workers"
54,West Virginia,232,2950,2950,0,0,0,0,162,162,0,0,0,0,23-2000,Legal Support Workers
54,West Virginia,251,6186,5058,1128,0,53,0,344,293,51,0,2,0,25-1000,Postsecondary Teachers
54,West Virginia,252,25634,24998,636,89,47,0,1553,1528,25,2,1,0,25-2000,"Preschool, Elementary, Middle, Secondary, and Special Education Teachers"
54,West Virginia,253,2940,2732,208,0,39,0,212,198,14,0,5,0,25-3000,Other Teachers and Instructors
54,West Virginia,254,786,781,5,0,0,0,58,56,2,0,0,0,25-4000,"Librarians, Curators, and Archivists"
54,West Virginia,259,4615,4456,159,0,14,0,311,300,11,0,2,0,25-9000,Other Educational Instruction and Library Occupations
54,West Virginia,271,2632,2630,2,0,0,0,138,135,3,0,0,0,27-1000,Art and Design Workers
54,West Virginia,272,2029,1815,214,0,9,93,140,131,9,0,1,1,27-2000,"Entertainers and Performers, Sports and Related Workers"
54,West Virginia,273,2710,2603,107,0,12,22,158,150,8,0,1,1,27-3000,Media and Communication Workers
54,West Virginia,274,1026,1025,1,0,0,0,53,51,2,0,1,0,27-4000,Media and Communication Equipment Workers
54,West Virginia,291,34623,33119,1504,15,48,0,1968,1888,80,1,3,1,29-1000,Healthcare Diagnosing or Treating Practitioners
54,West Virginia,292,21701,21267,434,0,0,24,1155,1137,18,0,0,2,29-2000,Health Technologists and Technicians
54,West Virginia,299,587,571,16,0,0,0,32,31,1,0,0,0,29-9000,Other Healthcare Practitioners and Technical Occupations
54,West Virginia,3111,22129,21620,509,0,0,21,1310,1292,18,1,0,2,31-1100,"Home Health and Personal Care Aides; and Nursing Assistants, Orderlies, and Psychiatric Aides"
54,West Virginia,312,817,817,0,0,0,0,52,49,3,0,0,0,31-2000,Occupational Therapy and Physical Therapist Assistants and Aides
54,West Virginia,319,7247,6980,267,18,0,0,412,400,12,1,0,0,31-9000,Other Healthcare Support Occupations
54,West Virginia,331,1827,1808,19,0,0,0,105,104,1,0,0,0,33-1000,Supervisors of Protective Service Workers
54,West Virginia,332,1338,1338,0,0,0,0,63,63,0,0,0,0,33-2000,Firefighting and Prevention Workers
54,West Virginia,333,8901,8845,56,0,0,0,425,422,3,0,0,0,33-3000,Law Enforcement Workers
54,West Virginia,339,5541,5513,28,0,0,9,450,445,5,0,0,1,33-9000,Other Protective Service Workers
54,West Virginia,351,4769,4602,167,0,0,0,240,232,8,0,0,0,35-1000,Supervisors of Food Preparation and Serving Workers
54,West Virginia,352,18439,17981,458,0,150,20,1177,1148,29,0,1,2,35-2000,Cooks and Food Preparation Workers
54,West Virginia,353,15066,14568,498,75,25,14,1004,980,24,4,1,2,35-3000,Food and Beverage Serving Workers
54,West Virginia,359,3954,3845,109,0,0,17,315,308,7,0,0,1,35-9000,Other Food Preparation and Serving Related Workers
54,West Virginia,371,2663,2647,16,0,0,14,116,114,2,0,0,1,37-1000,Supervisors of Building and Grounds Cleaning and Maintenance Workers
54,West Virginia,372,19798,19561,237,60,0,54,1277,1265,12,1,1,2,37-2000,Building Cleaning and Pest Control Workers
54,West Virginia,373,5819,5586,233,93,0,131,389,381,8,3,0,3,37-3000,Grounds Maintenance Workers
54,West Virginia,391,496,496,0,0,0,0,22,22,0,0,0,0,39-1000,Supervisors of Personal Care and Service Workers
54,West Virginia,392,1199,1199,0,0,0,0,80,80,0,0,0,0,39-2000,Animal Care and Service Workers
54,West Virginia,393,1535,1445,90,0,0,0,125,120,5,0,1,0,39-3000,Entertainment Attendants and Related Workers
54,West Virginia,394,479,479,0,0,0,0,29,29,0,0,0,0,39-4000,Funeral Service Workers
54,West Virginia,395,4423,4171,252,0,15,0,241,225,16,0,1,0,39-5000,Personal Appearance Workers
54,West Virginia,396,96,96,0,0,0,0,7,7,0,0,0,0,39-6000,"Baggage Porters, Bellhops, and Concierges"
54,West Virginia,397,357,357,0,0,0,0,31,30,1,0,0,0,39-7000,Tour and Travel Guides
54,West Virginia,399,7572,7459,113,5,7,0,529,521,8,1,1,0,39-9000,Other Personal Care and Service Workers
54,West Virginia,411,21087,20972,115,0,0,0,1145,1133,12,0,0,0,41-1000,Supervisors of Sales Workers
54,West Virginia,412,37021,36634,387,0,11,0,2478,2449,29,0,1,1,41-2000,Retail Sales Workers
54,West Virginia,413,4882,4871,11,0,0,0,266,265,1,0,0,0,41-3000,"Sales Representatives, Services"
54,West Virginia,414,3903,3817,86,0,0,0,214,211,3,0,0,0,41-4000,"Sales Representatives, Wholesale and Manufacturing"
54,West Virginia,419,3679,3609,70,0,40,0,244,238,6,0,1,0,41-9000,Other Sales and Related Workers
54,West Virginia,431,6190,6132,58,0,0,0,333,329,4,0,0,0,43-1000,Supervisors of Office and Administrative Support Workers
54,West Virginia,432,350,350,0,0,0,0,27,27,0,0,0,0,43-2000,Communications Equipment Operators
54,West Virginia,433,11067,10954,113,0,25,0,657,648,9,0,1,0,43-3000,Financial Clerks
54,West Virginia,434,21976,21741,235,0,0,0,1415,1402,13,0,0,0,43-4000,Information and Record Clerks
54,West Virginia,435,9764,9566,198,54,0,64,539,531,8,2,0,1,43-5000,"Material Recording, Scheduling, Dispatching, and Distributing Workers"
54,West Virginia,436,17860,17752,108,0,17,26,1061,1051,10,1,1,2,43-6000,Secretaries and Administrative Assistants
54,West Virginia,439,13041,12850,191,0,0,0,842,830,12,0,0,0,43-9000,Other Office and Administrative Support Workers
54,West Virginia,451,247,247,0,0,0,0,14,14,0,0,0,0,45-1000,"Supervisors of Farming, Fishing, and Forestry Workers"
54,West Virginia,452,1189,971,218,81,0,137,98,93,5,3,0,2,45-2000,Agricultural Workers
54,West Virginia,453,74,74,0,0,0,0,2,2,0,0,0,0,45-3000,Fishing and Hunting Workers
54,West Virginia,454,1032,1032,0,0,0,0,77,77,0,0,0,0,45-4000,"Forest, Conservation, and Logging Workers"
54,West Virginia,471,5956,5881,75,7,0,12,354,349,5,1,0,1,47-1000,Supervisors of Construction and Extraction Workers
54,West Virginia,472,32636,32150,486,163,166,8,1963,1947,16,4,2,1,47-2000,Construction Trades Workers
54,West Virginia,473,131,131,0,0,0,0,7,7,0,0,0,0,47-3000,"Helpers, Construction Trades"
54,West Virginia,474,2162,2152,10,0,0,0,134,132,2,0,1,0,47-4000,Other Construction and Related Workers
54,West Virginia,475,8011,7994,17,17,0,0,522,521,1,1,0,0,47-5000,Extraction Workers
54,West Virginia,491,2086,2072,14,0,0,14,111,110,1,0,0,1,49-1000,"Supervisors of Installation, Maintenance, and Repair Workers"
54,West Virginia,492,2419,2394,25,0,0,0,132,130,2,0,0,0,49-2000,"Electrical and Electronic Equipment Mechanics, Installers, and Repairers"
54,West Virginia,493,10820,10801,19,0,0,19,578,577,1,0,0,1,49-3000,"Vehicle and Mobile Equipment Mechanics, Installers, and Repairers"
54,West Virginia,499,11100,11049,51,0,9,0,637,633,4,0,1,0,49-9000,"Other Installation, Maintenance, and Repair Occupations"
54,West Virginia,511,4346,4158,188,0,0,47,244,237,7,0,0,1,51-1000,Supervisors of Production Workers
54,West Virginia,512,4384,4362,22,0,0,0,255,254,1,0,0,0,51-2000,Assemblers and Fabricators
54,West Virginia,513,2662,2565,97,0,0,0,147,145,2,0,0,0,51-3000,Food Processing Workers
54,West Virginia,514,7877,7859,18,0,0,0,432,430,2,0,0,0,51-4000,Metal Workers and Plastic Workers
54,West Virginia,5151,896,806,90,87,0,0,47,45,2,1,0,0,51-5100,Printing Workers
54,West Virginia,516,1804,1739,65,0,35,7,111,106,5,0,1,1,51-6000,"Textile, Apparel, and Furnishings Workers"
54,West Virginia,517,921,921,0,0,0,0,70,70,0,0,0,0,51-7000,Woodworkers
54,West Virginia,518,2292,2292,0,0,0,0,139,139,0,0,0,0,51-8000,Plant and System Operators
54,West Virginia,519,14557,14477,80,0,22,0,855,847,8,0,1,1,51-9000,Other Production Occupations
54,West Virginia,531,833,833,0,0,0,0,55,54,1,0,0,0,53-1000,Supervisors of Transportation and Material Moving Workers
54,West Virginia,532,418,418,0,0,0,0,31,31,0,0,0,0,53-2000,Air Transportation Workers
54,West Virginia,533,26302,25870,432,25,95,17,1438,1415,23,2,3,1,53-3000,Motor Vehicle Operators
54,West Virginia,534,1241,1241,0,0,0,0,72,72,0,0,0,0,53-4000,Rail Transportation Workers
54,West Virginia,535,563,563,0,0,0,0,26,25,1,0,0,0,53-5000,Water Transportation Workers
54,West Virginia,536,1090,1090,0,0,0,0,69,69,0,0,0,0,53-6000,Other Transportation Workers
54,West Virginia,537,27774,27216,558,0,75,54,1731,1698,33,0,4,2,53-7000,Material Moving Workers
55,Wisconsin,111,34939,33466,1473,0,168,116,1812,1760,52,0,6,2,11-1000,Top Executives
55,Wisconsin,112,18961,18138,823,137,0,163,853,827,26,1,1,3,11-2000,"Advertising, Marketing, Promotions, Public Relations, and Sales Managers"
55,Wisconsin,113,58703,55558,3145,62,148,154,2934,2828,106,1,7,4,11-3000,Operations Specialties Managers
55,Wisconsin,119,165685,157889,7796,306,290,2060,9957,9694,263,8,11,53,11-9000,Other Management Occupations
55,Wisconsin,131,88366,84559,3807,227,144,414,4399,4276,123,7,4,12,13-1000,Business Operations Specialists
55,Wisconsin,132,56301,54295,2006,96,62,240,2908,2829,79,2,4,8,13-2000,Financial Specialists
55,Wisconsin,1512,76574,66321,10253,113,188,358,3263,2978,285,3,7,12,15-1200,Computer Occupations
55,Wisconsin,152,3979,3385,594,0,0,0,171,158,13,0,0,0,15-2000,Mathematical Science Occupations
55,Wisconsin,171,3054,2952,102,0,0,16,135,132,3,0,0,1,17-1000,"Architects, Surveyors, and Cartographers"
55,Wisconsin,172,38487,35475,3012,109,110,147,1839,1747,92,2,5,4,17-2000,Engineers
55,Wisconsin,173,15396,14338,1058,172,0,97,813,787,26,2,0,5,17-3000,"Drafters, Engineering Technicians, and Mapping Technicians"
55,Wisconsin,191,6454,5406,1048,0,28,0,361,329,32,0,1,0,19-1000,Life Scientists
55,Wisconsin,192,7192,5893,1299,0,55,0,281,241,40,0,3,0,19-2000,Physical Scientists
55,Wisconsin,193,5103,4905,198,0,3,0,231,220,11,1,1,0,19-3000,Social Scientists and Related Workers
55,Wisconsin,194,9307,8487,820,0,58,64,496,474,22,0,1,3,19-4000,"Life, Physical, and Social Science Technicians"
55,Wisconsin,195,1396,1209,187,0,0,0,66,63,3,0,0,0,19-5000,Occupational Health and Safety Specialists and Technicians
55,Wisconsin,211,36390,34819,1571,72,141,287,1849,1801,48,3,4,11,21-1000,"Counselors, Social Workers, and Other Community and Social Service Specialists"
55,Wisconsin,212,8512,7833,679,27,98,20,503,465,38,1,11,1,21-2000,Religious Workers
55,Wisconsin,231,11368,11183,185,0,0,53,491,481,10,0,0,1,23-1000,"Lawyers, Judges, and Related Workers"
55,Wisconsin,232,6908,6848,60,0,0,0,308,303,5,0,1,2,23-2000,Legal Support Workers
55,Wisconsin,251,25493,20759,4734,78,167,123,1127,945,182,4,8,5,25-1000,Postsecondary Teachers
55,Wisconsin,252,100139,97789,2350,66,257,487,5561,5452,109,4,8,20,25-2000,"Preschool, Elementary, Middle, Secondary, and Special Education Teachers"
55,Wisconsin,253,13336,12811,525,0,111,13,735,706,29,0,3,1,25-3000,Other Teachers and Instructors
55,Wisconsin,254,5435,5252,183,0,31,0,304,295,9,0,1,0,25-4000,"Librarians, Curators, and Archivists"
55,Wisconsin,259,20677,19202,1475,0,86,378,1399,1331,68,0,7,18,25-9000,Other Educational Instruction and Library Occupations
55,Wisconsin,271,19670,19094,576,17,48,45,1028,996,32,1,4,3,27-1000,Art and Design Workers
55,Wisconsin,272,10160,9779,381,0,47,21,588,570,18,0,2,1,27-2000,"Entertainers and Performers, Sports and Related Workers"
55,Wisconsin,273,12584,11715,869,116,24,62,621,587,34,4,2,3,27-3000,Media and Communication Workers
55,Wisconsin,274,3699,3649,50,0,0,0,208,207,1,0,0,0,27-4000,Media and Communication Equipment Workers
55,Wisconsin,291,127211,120148,7063,36,301,235,6601,6351,250,2,10,6,29-1000,Healthcare Diagnosing or Treating Practitioners
55,Wisconsin,292,51082,48787,2295,74,135,223,2784,2722,62,2,2,3,29-2000,Health Technologists and Technicians
55,Wisconsin,299,1934,1896,38,0,0,0,111,110,1,0,0,0,29-9000,Other Healthcare Practitioners and Technical Occupations
55,Wisconsin,3111,71254,67729,3525,51,47,522,3746,3603,143,3,2,20,31-1100,"Home Health and Personal Care Aides; and Nursing Assistants, Orderlies, and Psychiatric Aides"
55,Wisconsin,312,2640,2584,56,0,0,46,170,165,5,0,0,3,31-2000,Occupational Therapy and Physical Therapist Assistants and Aides
55,Wisconsin,319,28124,27080,1044,26,38,193,1507,1469,38,1,1,10,31-9000,Other Healthcare Support Occupations
55,Wisconsin,331,4623,4615,8,0,0,0,278,277,1,0,0,0,33-1000,Supervisors of Protective Service Workers
55,Wisconsin,332,3679,3679,0,0,0,0,211,210,1,0,1,0,33-2000,Firefighting and Prevention Workers
55,Wisconsin,333,19090,18603,487,0,0,365,1067,1054,13,0,0,6,33-3000,Law Enforcement Workers
55,Wisconsin,339,15765,15217,548,0,0,183,966,941,25,0,0,4,33-9000,Other Protective Service Workers
55,Wisconsin,351,19154,17686,1468,0,0,511,826,784,42,0,0,11,35-1000,Supervisors of Food Preparation and Serving Workers
55,Wisconsin,352,63184,57899,5285,9,128,3451,3483,3299,184,2,4,95,35-2000,Cooks and Food Preparation Workers
55,Wisconsin,353,61421,58933,2488,82,339,594,3381,3264,117,6,8,24,35-3000,Food and Beverage Serving Workers
55,Wisconsin,359,17293,15530,1763,57,155,1117,1123,1071,52,3,5,20,35-9000,Other Food Preparation and Serving Related Workers
55,Wisconsin,371,7185,6841,344,0,69,206,352,338,14,0,2,10,37-1000,Supervisors of Building and Grounds Cleaning and Maintenance Workers
55,Wisconsin,372,67364,59270,8094,369,244,4840,4058,3817,241,14,8,134,37-2000,Building Cleaning and Pest Control Workers
55,Wisconsin,373,18076,15056,3020,56,0,2661,1351,1283,68,2,0,55,37-3000,Grounds Maintenance Workers
55,Wisconsin,391,1953,1943,10,0,0,10,103,101,2,0,0,1,39-1000,Supervisors of Personal Care and Service Workers
55,Wisconsin,392,6581,6352,229,0,0,115,399,389,10,0,0,3,39-2000,Animal Care and Service Workers
55,Wisconsin,393,4706,4640,66,0,14,0,374,364,10,0,1,0,39-3000,Entertainment Attendants and Related Workers
55,Wisconsin,394,1180,1180,0,0,0,0,58,58,0,0,0,0,39-4000,Funeral Service Workers
55,Wisconsin,395,17370,15118,2252,0,0,68,874,818,56,0,0,2,39-5000,Personal Appearance Workers
55,Wisconsin,396,465,465,0,0,0,0,22,22,0,0,0,0,39-6000,"Baggage Porters, Bellhops, and Concierges"
55,Wisconsin,397,968,890,78,0,0,0,87,82,5,0,0,0,39-7000,Tour and Travel Guides
55,Wisconsin,399,31479,30523,956,48,53,208,2023,1968,55,2,1,12,39-9000,Other Personal Care and Service Workers
55,Wisconsin,411,76047,72605,3442,41,21,1030,3867,3769,98,1,2,22,41-1000,Supervisors of Sales Workers
55,Wisconsin,412,108880,103992,4888,36,158,1277,6304,6106,198,4,14,37,41-2000,Retail Sales Workers
55,Wisconsin,413,24874,24498,376,0,0,70,1300,1280,20,0,0,4,41-3000,"Sales Representatives, Services"
55,Wisconsin,414,28881,28125,756,0,3,109,1484,1459,25,0,1,6,41-4000,"Sales Representatives, Wholesale and Manufacturing"
55,Wisconsin,419,18437,17740,697,0,0,101,937,915,22,0,0,2,41-9000,Other Sales and Related Workers
55,Wisconsin,431,20956,19993,963,0,52,208,1106,1074,32,0,3,6,43-1000,Supervisors of Office and Administrative Support Workers
55,Wisconsin,432,1093,1061,32,0,0,0,70,68,2,0,0,1,43-2000,Communications Equipment Operators
55,Wisconsin,433,46020,44147,1873,125,343,272,2705,2641,64,2,7,11,43-3000,Financial Clerks
55,Wisconsin,434,102486,99088,3398,83,137,886,5480,5350,130,6,5,25,43-4000,Information and Record Clerks
55,Wisconsin,435,45568,43723,1845,68,73,678,2569,2513,56,3,2,23,43-5000,"Material Recording, Scheduling, Dispatching, and Distributing Workers"
55,Wisconsin,436,49844,48627,1217,52,10,346,3340,3288,52,2,2,12,43-6000,Secretaries and Administrative Assistants
55,Wisconsin,439,55327,53535,1792,19,15,575,3207,3132,75,3,3,20,43-9000,Other Office and Administrative Support Workers
55,Wisconsin,451,1039,909,130,0,0,130,87,85,2,0,0,2,45-1000,"Supervisors of Farming, Fishing, and Forestry Workers"
55,Wisconsin,452,23644,17412,6232,999,140,4820,2300,2021,279,32,6,223,45-2000,Agricultural Workers
55,Wisconsin,453,86,86,0,0,0,0,15,15,0,0,0,0,45-3000,Fishing and Hunting Workers
55,Wisconsin,454,1938,1877,61,0,0,61,220,219,1,0,0,1,45-4000,"Forest, Conservation, and Logging Workers"
55,Wisconsin,471,10700,10401,299,26,46,172,809,795,14,1,1,8,47-1000,Supervisors of Construction and Extraction Workers
55,Wisconsin,472,108699,102624,6075,541,128,4197,7260,7078,182,8,6,104,47-2000,Construction Trades Workers
55,Wisconsin,473,309,309,0,0,0,0,30,30,0,0,0,0,47-3000,"Helpers, Construction Trades"
55,Wisconsin,474,6062,5737,325,0,0,308,454,442,12,0,0,9,47-4000,Other Construction and Related Workers
55,Wisconsin,475,1386,1301,85,0,0,85,122,120,2,0,0,2,47-5000,Extraction Workers
55,Wisconsin,491,4859,4524,335,0,0,14,313,309,4,0,0,1,49-1000,"Supervisors of Installation, Maintenance, and Repair Workers"
55,Wisconsin,492,6505,6288,217,0,19,6,366,360,6,0,1,1,49-2000,"Electrical and Electronic Equipment Mechanics, Installers, and Repairers"
55,Wisconsin,493,34113,32901,1212,28,57,715,2142,2108,34,2,2,13,49-3000,"Vehicle and Mobile Equipment Mechanics, Installers, and Repairers"
55,Wisconsin,499,47390,45581,1809,178,194,659,2897,2843,54,4,2,22,49-9000,"Other Installation, Maintenance, and Repair Occupations"
55,Wisconsin,511,27050,25612,1438,26,0,991,1654,1601,53,1,1,33,51-1000,Supervisors of Production Workers
55,Wisconsin,512,44513,38865,5648,61,159,2766,2402,2228,174,4,3,72,51-2000,Assemblers and Fabricators
55,Wisconsin,513,20706,16635,4071,98,53,2745,1079,965,114,3,3,72,51-3000,Food Processing Workers
55,Wisconsin,514,63673,58946,4727,84,0,3029,3709,3569,140,2,0,76,51-4000,Metal Workers and Plastic Workers
55,Wisconsin,5151,9952,9376,576,0,27,215,483,467,16,0,1,8,51-5100,Printing Workers
55,Wisconsin,516,7443,5938,1505,82,0,772,468,418,50,2,0,19,51-6000,"Textile, Apparel, and Furnishings Workers"
55,Wisconsin,517,4534,4348,186,0,0,137,337,328,9,0,0,6,51-7000,Woodworkers
55,Wisconsin,518,5173,5143,30,0,0,0,321,318,3,0,0,1,51-8000,Plant and System Operators
55,Wisconsin,519,97741,86771,10970,294,143,6027,5818,5469,349,12,9,172,51-9000,Other Production Occupations
55,Wisconsin,531,3752,3541,211,0,0,18,212,208,4,0,0,1,53-1000,Supervisors of Transportation and Material Moving Workers
55,Wisconsin,532,2910,2842,68,0,0,0,155,153,2,0,0,0,53-2000,Air Transportation Workers
55,Wisconsin,533,79434,75213,4221,213,70,1269,4971,4858,113,4,2,36,53-3000,Motor Vehicle Operators
55,Wisconsin,534,1464,1429,35,0,0,35,118,117,1,0,0,1,53-4000,Rail Transportation Workers
55,Wisconsin,535,412,412,0,0,0,0,35,35,0,0,0,0,53-5000,Water Transportation Workers
55,Wisconsin,536,3157,2991,166,61,0,0,189,185,4,2,0,0,53-6000,Other Transportation Workers
55,Wisconsin,537,124072,114967,9105,627,301,4985,7481,7159,322,17,12,158,53-7000,Material Moving Workers
56,Wyoming,111,3407,3246,161,0,0,0,204,196,8,0,0,0,11-1000,Top Executives
56,Wyoming,112,983,983,0,0,0,0,45,45,0,0,0,0,11-2000,"Advertising, Marketing, Promotions, Public Relations, and Sales Managers"
56,Wyoming,113,3544,3463,81,0,0,56,205,201,4,0,0,2,11-3000,Operations Specialties Managers
56,Wyoming,119,17805,17024,781,0,19,413,1016,986,30,0,1,12,11-9000,Other Management Occupations
56,Wyoming,131,4568,4385,183,0,0,0,265,261,4,0,0,0,13-1000,Business Operations Specialists
56,Wyoming,132,3359,3206,153,0,0,0,203,196,7,0,0,0,13-2000,Financial Specialists
56,Wyoming,1512,3449,3327,122,17,0,0,164,161,3,1,0,0,15-1200,Computer Occupations
56,Wyoming,152,146,146,0,0,0,0,6,6,0,0,0,0,15-2000,Mathematical Science Occupations
56,Wyoming,171,363,363,0,0,0,0,22,22,0,0,0,0,17-1000,"Architects, Surveyors, and Cartographers"
56,Wyoming,172,3769,3689,80,0,0,0,167,163,4,0,0,0,17-2000,Engineers
56,Wyoming,173,1328,1328,0,0,0,0,74,74,0,0,0,0,17-3000,"Drafters, Engineering Technicians, and Mapping Technicians"
56,Wyoming,191,559,531,28,0,0,0,44,43,1,0,0,0,19-1000,Life Scientists
56,Wyoming,192,781,698,83,0,14,0,48,41,7,0,1,0,19-2000,Physical Scientists
56,Wyoming,193,502,450,52,0,0,28,23,21,2,0,0,1,19-3000,Social Scientists and Related Workers
56,Wyoming,194,899,876,23,0,0,0,61,59,2,0,0,0,19-4000,"Life, Physical, and Social Science Technicians"
56,Wyoming,195,301,272,29,0,0,0,13,12,1,0,0,0,19-5000,Occupational Health and Safety Specialists and Technicians
56,Wyoming,211,4029,4029,0,0,0,0,220,220,0,0,0,0,21-1000,"Counselors, Social Workers, and Other Community and Social Service Specialists"
56,Wyoming,212,875,862,13,0,0,2,56,52,4,0,0,2,21-2000,Religious Workers
56,Wyoming,231,1322,1279,43,0,0,0,75,73,2,0,0,0,23-1000,"Lawyers, Judges, and Related Workers"
56,Wyoming,232,751,751,0,0,0,0,48,48,0,0,0,0,23-2000,Legal Support Workers
56,Wyoming,251,2677,2259,418,19,16,0,147,125,22,1,1,0,25-1000,Postsecondary Teachers
56,Wyoming,252,10827,10657,170,15,0,13,709,699,10,1,1,1,25-2000,"Preschool, Elementary, Middle, Secondary, and Special Education Teachers"
56,Wyoming,253,1452,1399,53,0,0,24,90,88,2,0,0,1,25-3000,Other Teachers and Instructors
56,Wyoming,254,1100,1063,37,0,0,0,61,59,2,0,0,0,25-4000,"Librarians, Curators, and Archivists"
56,Wyoming,259,4087,3743,344,26,0,99,242,230,12,1,0,3,25-9000,Other Educational Instruction and Library Occupations
56,Wyoming,271,1197,1197,0,0,0,0,67,67,0,0,0,0,27-1000,Art and Design Workers
56,Wyoming,272,894,876,18,0,0,0,55,53,2,0,0,0,27-2000,"Entertainers and Performers, Sports and Related Workers"
56,Wyoming,273,1161,1129,32,0,0,32,64,61,3,0,0,1,27-3000,Media and Communication Workers
56,Wyoming,274,453,453,0,0,0,0,26,26,0,0,0,0,27-4000,Media and Communication Equipment Workers
56,Wyoming,291,10302,9865,437,0,52,0,561,542,19,0,2,1,29-1000,Healthcare Diagnosing or Treating Practitioners
56,Wyoming,292,3988,3933,55,0,0,24,213,209,4,0,0,1,29-2000,Health Technologists and Technicians
56,Wyoming,299,119,119,0,0,0,0,6,6,0,0,0,0,29-9000,Other Healthcare Practitioners and Technical Occupations
56,Wyoming,3111,6163,5968,195,43,0,0,311,300,11,1,0,2,31-1100,"Home Health and Personal Care Aides; and Nursing Assistants, Orderlies, and Psychiatric Aides"
56,Wyoming,312,174,174,0,0,0,0,12,12,0,0,0,0,31-2000,Occupational Therapy and Physical Therapist Assistants and Aides
56,Wyoming,319,1983,1863,120,0,0,120,123,119,4,1,0,2,31-9000,Other Healthcare Support Occupations
56,Wyoming,331,476,476,0,0,0,0,35,35,0,0,0,0,33-1000,Supervisors of Protective Service Workers
56,Wyoming,332,524,491,33,0,0,0,37,35,2,0,0,0,33-2000,Firefighting and Prevention Workers
56,Wyoming,333,2640,2635,5,0,5,0,140,139,1,0,1,0,33-3000,Law Enforcement Workers
56,Wyoming,339,2060,1976,84,0,0,82,125,122,3,0,0,2,33-9000,Other Protective Service Workers
56,Wyoming,351,2651,2543,108,0,0,17,112,108,4,0,0,1,35-1000,Supervisors of Food Preparation and Serving Workers
56,Wyoming,352,6591,5912,679,35,0,502,405,376,29,1,0,21,35-2000,Cooks and Food Preparation Workers
56,Wyoming,353,6703,6296,407,0,0,165,404,383,21,0,0,7,35-3000,Food and Beverage Serving Workers
56,Wyoming,359,1344,1344,0,0,0,0,105,102,3,0,0,0,35-9000,Other Food Preparation and Serving Related Workers
56,Wyoming,371,1023,1023,0,0,0,0,44,44,0,0,0,0,37-1000,Supervisors of Building and Grounds Cleaning and Maintenance Workers
56,Wyoming,372,8102,6750,1352,108,72,785,549,497,52,6,3,25,37-2000,Building Cleaning and Pest Control Workers
56,Wyoming,373,2036,1999,37,0,0,37,150,148,2,0,0,1,37-3000,Grounds Maintenance Workers
56,Wyoming,391,150,150,0,0,0,0,9,9,0,0,0,0,39-1000,Supervisors of Personal Care and Service Workers
56,Wyoming,392,418,393,25,0,0,6,42,39,3,0,0,1,39-2000,Animal Care and Service Workers
56,Wyoming,393,515,507,8,0,0,0,32,31,1,0,0,0,39-3000,Entertainment Attendants and Related Workers
56,Wyoming,394,106,106,0,0,0,0,6,6,0,0,0,0,39-4000,Funeral Service Workers
56,Wyoming,395,1582,1488,94,0,0,0,75,73,2,0,0,0,39-5000,Personal Appearance Workers
56,Wyoming,396,199,199,0,0,0,0,6,6,0,0,0,0,39-6000,"Baggage Porters, Bellhops, and Concierges"
56,Wyoming,397,562,543,19,0,0,0,23,22,1,0,0,0,39-7000,Tour and Travel Guides
56,Wyoming,399,3344,3098,246,0,0,93,217,207,10,0,0,1,39-9000,Other Personal Care and Service Workers
56,Wyoming,411,9492,9240,252,0,0,208,466,455,11,0,0,6,41-1000,Supervisors of Sales Workers
56,Wyoming,412,9790,9605,185,0,24,0,594,579,15,0,1,2,41-2000,Retail Sales Workers
56,Wyoming,413,1802,1781,21,0,0,0,89,86,3,0,0,0,41-3000,"Sales Representatives, Services"
56,Wyoming,414,1212,1188,24,0,0,0,63,61,2,0,0,0,41-4000,"Sales Representatives, Wholesale and Manufacturing"
56,Wyoming,419,1326,1248,78,0,0,0,83,82,1,0,0,0,41-9000,Other Sales and Related Workers
56,Wyoming,431,2178,2178,0,0,0,0,125,125,0,0,0,0,43-1000,Supervisors of Office and Administrative Support Workers
56,Wyoming,432,187,187,0,0,0,0,6,6,0,0,0,0,43-2000,Communications Equipment Operators
56,Wyoming,433,4868,4750,118,0,30,0,285,278,7,0,2,0,43-3000,Financial Clerks
56,Wyoming,434,7874,7535,339,17,31,194,432,418,14,1,1,4,43-4000,Information and Record Clerks
56,Wyoming,435,2847,2746,101,0,64,0,185,182,3,0,1,0,43-5000,"Material Recording, Scheduling, Dispatching, and Distributing Workers"
56,Wyoming,436,6426,6350,76,0,0,47,422,419,3,0,0,2,43-6000,Secretaries and Administrative Assistants
56,Wyoming,439,3823,3730,93,0,0,0,234,226,8,0,0,1,43-9000,Other Office and Administrative Support Workers
56,Wyoming,451,278,278,0,0,0,0,20,19,1,0,0,0,45-1000,"Supervisors of Farming, Fishing, and Forestry Workers"
56,Wyoming,452,2871,2620,251,0,13,197,240,228,12,0,2,7,45-2000,Agricultural Workers
56,Wyoming,453,50,50,0,0,0,0,5,5,0,0,0,0,45-3000,Fishing and Hunting Workers
56,Wyoming,454,44,44,0,0,0,0,7,7,0,0,0,0,45-4000,"Forest, Conservation, and Logging Workers"
56,Wyoming,471,3507,3356,151,0,0,113,176,167,9,0,0,6,47-1000,Supervisors of Construction and Extraction Workers
56,Wyoming,472,15857,14486,1371,171,37,1089,878,833,45,9,1,28,47-2000,Construction Trades Workers
56,Wyoming,473,0,0,0,0,0,0,1,1,0,0,0,0,47-3000,"Helpers, Construction Trades"
56,Wyoming,474,1006,1006,0,0,0,0,57,57,0,0,0,0,47-4000,Other Construction and Related Workers
56,Wyoming,475,5823,5634,189,9,21,159,289,280,9,1,1,6,47-5000,Extraction Workers
56,Wyoming,491,858,858,0,0,0,0,39,39,0,0,0,0,49-1000,"Supervisors of Installation, Maintenance, and Repair Workers"
56,Wyoming,492,830,830,0,0,0,0,48,48,0,0,0,0,49-2000,"Electrical and Electronic Equipment Mechanics, Installers, and Repairers"
56,Wyoming,493,6232,6129,103,0,0,39,296,292,4,0,0,2,49-3000,"Vehicle and Mobile Equipment Mechanics, Installers, and Repairers"
56,Wyoming,499,4381,4138,243,0,38,195,248,241,7,0,1,4,49-9000,"Other Installation, Maintenance, and Repair Occupations"
56,Wyoming,511,1614,1614,0,0,0,0,84,84,0,0,0,0,51-1000,Supervisors of Production Workers
56,Wyoming,512,539,501,38,0,0,0,41,40,1,0,0,0,51-2000,Assemblers and Fabricators
56,Wyoming,513,529,524,5,0,0,0,53,52,1,0,0,0,51-3000,Food Processing Workers
56,Wyoming,514,3566,3468,98,0,0,98,172,167,5,0,0,5,51-4000,Metal Workers and Plastic Workers
56,Wyoming,5151,131,131,0,0,0,0,9,9,0,0,0,0,51-5100,Printing Workers
56,Wyoming,516,718,647,71,0,0,50,37,35,2,0,0,1,51-6000,"Textile, Apparel, and Furnishings Workers"
56,Wyoming,517,99,84,15,0,0,15,14,13,1,0,0,1,51-7000,Woodworkers
56,Wyoming,518,1903,1897,6,6,0,0,103,102,1,1,0,0,51-8000,Plant and System Operators
56,Wyoming,519,3494,3439,55,0,0,27,190,182,8,0,0,4,51-9000,Other Production Occupations
56,Wyoming,531,409,409,0,0,0,0,27,27,0,0,0,0,53-1000,Supervisors of Transportation and Material Moving Workers
56,Wyoming,532,305,305,0,0,0,0,23,23,0,0,0,0,53-2000,Air Transportation Workers
56,Wyoming,533,10403,10160,243,0,29,192,562,555,7,0,1,3,53-3000,Motor Vehicle Operators
56,Wyoming,534,1596,1596,0,0,0,0,89,89,0,0,0,0,53-4000,Rail Transportation Workers
56,Wyoming,535,11,11,0,0,0,0,1,1,0,0,0,0,53-5000,Water Transportation Workers
56,Wyoming,536,600,594,6,0,0,6,35,34,1,0,0,1,53-6000,Other Transportation Workers
56,Wyoming,537,8928,8429,499,68,0,203,521,501,20,1,0,9,53-7000,Material Moving Workers
